30 100
GAGACGATTAACTATCCTCTTTGCATAAAC|CGCCGCGTCTCGCCTTCATAGCAGCAGACG
TGCATAAACGAGCCCTTAACTTTAACTATC|TGAAAGGGTCTTAACTATCCTCTTTGCATA
AGGACGCATGGACAAGCGGCACCAGGAACC|AAACGAGCCCTGTTTAGTCCCTCTGATAAT
ATGTCGATGGCGGCGCGCTTAACTATCCTC|ACGCGCGATCTAGACGGTACAACTCGGCGG
CACGGCATAGCTTCTAGAACCCCACGCTCC|GATCATTTCTCCTCATGAATTCGACAACCC
TCATAAGGACGCATGGACAAGCGGCACCAG|TGCATAAACGAGCCCTGTTTAGTCCCTCTG
GCGGAAGATCCTGCCTGTGCGCCGCTATCC|CCTCTTTGCATAAACGAGCCCTGCGACATT
TCGATGGCGGCGCGCTTAACTATCCTCTTT|CGCGATCTAGACGGTACAACTCGGCGGAGC
CTCGGCGGAGCGGAACTCGCTAATAGGGAA|GTGTCGCATGGGAATGGTTCGAGCTCGTTC
TTAACTATCCTCTTTGCATAAACGAGCCCT|TGATAAGGGGGCTGAAGCTGCAGGACGAGA
CATAGCTTCTAGAACCCCACGCTCCCACTG|TTTCTCCTCATGAATTCGACAACCCAACCA
TCTGGCTCCATTCAGCCCGAGACGATTAAC|TCACTAACCTTGAGTTTACGCCGCGTCTCG
TCCTCTTTGCATAAACGAGCCCTCCTCTTT|GCATAGCTTCTAGAACCCCACGCTCCCACT
GCCTCATAAGGACGCATGGACAAGCGGCAC|CTTTGCATAAACGAGCCCTGTTTAGTCCCT
CGACATTGCTTTACGGCGCCTTTAGTGCCT|AACAATTGGCCTGTCCTTAGTACACCATGA
TGACAATTTCTAGGAGTGCTTACTTGTATA|TACTGTGCCGGCACGAGCGAAATGGAGTTG
GCGGAGCGGAACTCGCTAATAGGGAAATTA|CGCATGGGAATGGTTCGAGCTCGTTCTAGT
TTGCATAAACGAGCCCTAGTCCCACGGCAG|ACGATGCCCCCCGTGACCACATTACATACA
GAAATTAACTATCTTAACTATCCTCTTTGC|TTCTAGTGCGTGCCACGGGCTACTTCGTAG
CTCTTTGCATAAACGAGCCCTTGCACCCAA|GTCAGATAGCAACTGACAATTTCTAGGAGT
ATCGTTTGGGAACTTTAACTATTTAACTAT|CCTTGCACCCAAACTCGTACACATGCACGG
TAAACGAGCCCTAGCGAGTCCCGGCCTCTA|ATCTTATGTCGATGGCGGCGCGCTTAACTA
AACCATTAATGTTAACTATCCTCTTTGCAT|TAATCCATCGGACATCTAACGATACTACCC
AGGAACCATTAATGTTAACTATCCTCTTTG|TGATAATCCATCGGACATCTAACGATACTA
TCAGACGCCCACGCTTCTCCCGCGGAATCG|GCCCTATCCTCTTTGCATAAACGAGCCCTT
CTCGTACACATGCACGGCATAGCTTCTAGA|CTTACTTGTATAGATCATTTCTCCTCATGA
CCGTGACCACATTACATACACTACGAAGCG|ATGGCCTCATAAGGACGCATGGACAAGCGG
TCATTTCTCCTCATGAATTCGACAACCCAA|TTTCTGGCTCCATTCAGCCCGAGACGATTA
GCCAGGCAATTATTTCGTGCACCACGATGC|CATAAACGAGCCCTAGCGAGTCCCGGCCTC
CGATTAACTATCCTCTTTGCATAAACGAGC|GCGTCTCGCCTTCATAGCAGCAGACGGTGA
CATTCAGCCCGAGACGATTAACTATCCTCT|CTTGAGTTTACGCCGCGTCTCGCCTTCATA
ATCCTCTTTGCATAAACGAGCCCTCTCTTT|CTACTTCGTAGCCCCGCCGAATCAGACGCC
AGCCCTCCCTTAAAGTATCGCGCGCGCTAG|ACGAGAACGGTTCTTAACTATCCTCTTTGC
AACGAGCCCTGTTTAGTCCCTCTGATAATC|TCGCTAATAGGGAAATTAACTATCTTAACT
TCATGAATTCGACAACCCAACCATAGCGGA|CATTCAGCCCGAGACGATTAACTATCCTCT
TTCGTAGCCCCGCCGAATCAGACGCCCACG|CCTCTTTGCATAAACGAGCCCTATCCTCTT
CCCTAGCGAGTCCCGGCCTCTAAATGGCCT|TCGATGGCGGCGCGCTTAACTATCCTCTTT
TCCTCTTTGCATAAACGAGCCCTAGCGAGT|TTCCACCGATTATCTTATGTCGATGGCGGC
CCTGTGCGCCGCTATCCAACTTCGTATATG|ACGAGCCCTGCGACATTGCTTTACGGCGCC
GATTAACTATCCTCTTTGCATAAACGAGCC|TCCCGCGGAATCGTTTGGGAACTTTAACTA
TTAACTATCCTCTTTGCATAAACGAGCCCT|GATCCTGCCTGTGCGCCGCTATCCAACTTC
TCCCGCGGAATCGTTTGGGAACTTTAACTA|TAAACGAGCCCTTGCACCCAAACTCGTACA
ATAAGGACGCATGGACAAGCGGCACCAGGA|CATAAACGAGCCCTGTTTAGTCCCTCTGAT
ACTGTGCCGGCACGAGCGAAATGGAGTTGG|AGACACTATTGTACGCGTGCAGCCGATCTA
CTCTTTGCATAAACGAGCCCTCCTCTTTGC|ATAGCTTCTAGAACCCCACGCTCCCACTGA
CCGCGGAATCGTTTGGGAACTTTAACTATT|AACGAGCCCTTGCACCCAAACTCGTACACA
GGAATCGTTTGGGAACTTTAACTATTTAAC|AGCCCTTGCACCCAAACTCGTACACATGCA
CTAACGATACTACCCATTAATTTAACTATC|CATAAACGAGCCCTCTCTTTGCATAAACGA
ATTAATTTAACTATCCTCTTTGCATAAACG|TCTTTGCATAAACGATTAACTATCCTCTTT
TTTGCATAAACGAGCCCTAGCGAGTCCCGG|CCGATTATCTTATGTCGATGGCGGCGCGCT
CACGATGCCCCCCGTGACCACATTACATAC|CCGGCCTCTAAATGGCCTCATAAGGACGCA
CGTTAGTGTCGCATGGGAATGGTTCGAGCT|TCTTTGCATAAACGAGCCCTCCTCTTTGCA
GCATAAACGAGCCCTAGTCCCACGGCAGCA|GATGCCCCCCGTGACCACATTACATACACT
GACCACATTACATACACTACGAAGCGGTGA|CCTCATAAGGACGCATGGACAAGCGGCACC
CCCACTGAAAGGGTCTTAACTATCCTCTTT|CCAACCATAGCGGAAGATCCTGCCTGTGCG
ACGCCCACGCTTCTCCCGCGGAATCGTTTG|TATCCTCTTTGCATAAACGAGCCCTTGCAC
CGCATGGGAATGGTTCGAGCTCGTTCTAGT|AAACGAGCCCTCCTCTTTGCATAAACGAGC
AAACGAGCCCTGTTTAGTCCCTCTGATAAT|CTCGCTAATAGGGAAATTAACTATCTTAAC
TAACGCGCGATCTAGACGGTACAACTCGGC|AACGAGCCCTGCCCTCTTACGTTAGTGTCG
ACGGCATAGCTTCTAGAACCCCACGCTCCC|ATCATTTCTCCTCATGAATTCGACAACCCA
GCCTGTGCGCCGCTATCCAACTTCGTATAT|AACGAGCCCTGCGACATTGCTTTACGGCGC
AACTATCCTCTTTGCATAAACGAGCCCTGC|GCGGAATCGTTTGGGAACTTTAACTATTTA
GGAACTCGCTAATAGGGAAATTAACTATCT|GAATGGTTCGAGCTCGTTCTAGTGCGTGCC
TGATAATCCATCGGACATCTAACGATACTA|TCTTAACTATCCTCTTTGCATAAACGAGCC
GCGGAATCGTTTGGGAACTTTAACTATTTA|CGAGCCCTTGCACCCAAACTCGTACACATG
CTTAACTATCCTCTTTGCATAAACGAGCCC|TTATTTCGTGCACCACGATGCCCCCCGTGA
TCCTCTTTGCATAAACGAGCCCTATACAAG|CCTGTGCGCCGCTATCCAACTTCGTATATG
CGTGCCACGGGCTACTTCGTAGCCCCGCCG|CTTAACTTTAACTATCCTCTTTGCATAAAC
GAACCCCACGCTCCCACTGAAAGGGTCTTA|GAATTCGACAACCCAACCATAGCGGAAGAT
CGAGCCCTAGCGAGTCCCGGCCTCTAAATG|TATGTCGATGGCGGCGCGCTTAACTATCCT
CTCCCACTGAAAGGGTCTTAACTATCCTCT|ACCCAACCATAGCGGAAGATCCTGCCTGTG
CACCAGGAACCATTAATGTTAACTATCCTC|CCTCTGATAATCCATCGGACATCTAACGAT
ACGCATGGACAAGCGGCACCAGGAACCATT|CGAGCCCTGTTTAGTCCCTCTGATAATCCA
TTGTATAGATCATTTCTCCTCATGAATTCG|GGAGTTGGGTTTCTGGCTCCATTCAGCCCG
GTAGCCCCGCCGAATCAGACGCCCACGCTT|CTTTGCATAAACGAGCCCTATCCTCTTTGC
GACTAGGCTCGATTAACTATCCTCTTTGCA|GAGTGCAGACGCTGATAAGGGGGCTGAAGC
TAGCGAGTCCCGGCCTCTAAATGGCCTCAT|ATGGCGGCGCGCTTAACTATCCTCTTTGCA
TGCACCCAAACTCGTACACATGCACGGCAT|TCTAGGAGTGCTTACTTGTATAGATCATTT
ACTCTCGCTTTAAGTACTGTGCCGGCACGA|GCCTCTTTGTGTTTCAGACACTATTGTACG
GTTTGGGAACTTTAACTATTTAACTATCCT|TGCACCCAAACTCGTACACATGCACGGCAT
GAGCCCTGTTTAGTCCCTCTGATAATCCAT|CTAATAGGGAAATTAACTATCTTAACTATC
TACTACCCATTAATTTAACTATCCTCTTTG|GAGCCCTCTCTTTGCATAAACGATTAACTA
CCAACCATAGCGGAAGATCCTGCCTGTGCG|ATTAACTATCCTCTTTGCATAAACGAGCCC
GCGTGCCACGGGCTACTTCGTAGCCCCGCC|CCTTAACTTTAACTATCCTCTTTGCATAAA
CGAGTCCCGGCCTCTAAATGGCCTCATAAG|GCGGCGCGCTTAACTATCCTCTTTGCATAA
TCGCTTTAAGTACTGTGCCGGCACGAGCGA|CTTTGTGTTTCAGACACTATTGTACGCGTG
AATCCTACGAAAGCGACGAAGCTTAACTAT|TCGCGCGCGCTAGCCAGGCAATTATTTCGT
TTTGCATAAACGATTAACTATCCTCTTTGC|GCCCACGCTTCTCCCGCGGAATCGTTTGGG
GGACATCTAACGATACTACCCATTAATTTA|TCTTTGCATAAACGAGCCCTCTCTTTGCAT
CTAATAGGGAAATTAACTATCTTAACTATC|CGAGCTCGTTCTAGTGCGTGCCACGGGCTA
GGTTTCTGGCTCCATTCAGCCCGAGACGAT|AAGTTCACTAACCTTGAGTTTACGCCGCGT
TACACTACGAAGCGGTGAGTGCAGACGCTG|GCATGGACAAGCGGCACCAGGAACCATTAA
GACGCATGGACAAGCGGCACCAGGAACCAT|ACGAGCCCTGTTTAGTCCCTCTGATAATCC
GGTTCTTAACTATCCTCTTTGCATAAACGA|CTATAGGAGTGTTTCCACCGATTATCTTAT
ATACTACCCATTAATTTAACTATCCTCTTT|CGAGCCCTCTCTTTGCATAAACGATTAACT
CGCGCGCTAGCCAGGCAATTATTTCGTGCA|TCCTCTTTGCATAAACGAGCCCTAGCGAGT
CAATTTCTAGGAGTGCTTACTTGTATAGAT|TGTGCCGGCACGAGCGAAATGGAGTTGGGT
GACGAAGCTTAACTATCCTCTTTGCATAAA|CAGGCAATTATTTCGTGCACCACGATGCCC
CTTTAAGTACTGTGCCGGCACGAGCGAAAT|TGTGTTTCAGACACTATTGTACGCGTGCAG
ACGCTCCCACTGAAAGGGTCTTAACTATCC|ACAACCCAACCATAGCGGAAGATCCTGCCT
TAAACGAGCCCTCTCTTTGCATAAACGATT|CCCGCCGAATCAGACGCCCACGCTTCTCCC
TATTTAACTATCCTCTTTGCATAAACGAGC|CACATGCACGGCATAGCTTCTAGAACCCCA
TAACTTTAACTATCCTCTTTGCATAAACGA|ATCCTCTTTGCATAAACGAGCCCTATACAA
CCCAAACTCGTACACATGCACGGCATAGCT|GGAGTGCTTACTTGTATAGATCATTTCTCC
CTTTAACTATCCTCTTTGCATAAACGAGCC|CTCTTTGCATAAACGAGCCCTATACAAGTT
CCAACTTCGTATATGTCGGAGACTCTCGCT|TTGCTTTACGGCGCCTTTAGTGCCTCTTTG
TGCGCCGCTATCCAACTTCGTATATGTCGG|GCCCTGCGACATTGCTTTACGGCGCCTTTA
GGAACCATTAATGTTAACTATCCTCTTTGC|GATAATCCATCGGACATCTAACGATACTAC
GAGCCCTATACAAGTTTCCGCGTCAGATAG|CAACTTCGTATATGTCGGAGACTCTCGCTT
TTCTCCTCATGAATTCGACAACCCAACCAT|TGGCTCCATTCAGCCCGAGACGATTAACTA
TCCTCTTTGCATAAACGAGCCCTATAGGAG|ACGATACTACCCATTAATTTAACTATCCTC
CATGAATTCGACAACCCAACCATAGCGGAA|ATTCAGCCCGAGACGATTAACTATCCTCTT
TCCTGCCTGTGCGCCGCTATCCAACTTCGT|CATAAACGAGCCCTGCGACATTGCTTTACG
CTGCCTGTGCGCCGCTATCCAACTTCGTAT|TAAACGAGCCCTGCGACATTGCTTTACGGC
GAGTGTTTCCACCGATTATCTTATGTCGAT|CTCTTTGCATAAACGAGCCCTAACGCGCGA
ACATACACTACGAAGCGGTGAGTGCAGACG|GACGCATGGACAAGCGGCACCAGGAACCAT
GCTTCTAGAACCCCACGCTCCCACTGAAAG|TCCTCATGAATTCGACAACCCAACCATAGC
AGCAGGATAAAGCGGACTAGGCTCGATTAA|CACTACGAAGCGGTGAGTGCAGACGCTGAT
AAATTAACTATCTTAACTATCCTCTTTGCA|TCTAGTGCGTGCCACGGGCTACTTCGTAGC
CCTTAACTTTAACTATCCTCTTTGCATAAA|ACTATCCTCTTTGCATAAACGAGCCCTATA
GAATCGTTTGGGAACTTTAACTATTTAACT|GCCCTTGCACCCAAACTCGTACACATGCAC
TTATCTTATGTCGATGGCGGCGCGCTTAAC|AGCCCTAACGCGCGATCTAGACGGTACAAC
ATCCAACTTCGTATATGTCGGAGACTCTCG|CATTGCTTTACGGCGCCTTTAGTGCCTCTT
TAAACGAGCCCTGCCCTCTTACGTTAGTGT|ACTTTAACTATTTAACTATCCTCTTTGCAT
ACTATCCTCTTTGCATAAACGAGCCCTAGC|GTGTTTCCACCGATTATCTTATGTCGATGG
TAACTATCCTCTTTGCATAAACGAGCCCTG|CAACTCGGCGGAGCGGAACTCGCTAATAGG
ACTTTAACTATCCTCTTTGCATAAACGAGC|CCTCTTTGCATAAACGAGCCCTATACAAGT
TGCATAAACGAGCCCTGCCCTCTTACGTTA|GGGAACTTTAACTATTTAACTATCCTCTTT
GCCCTATAGGAGTGTTTCCACCGATTATCT|TTAACTATCCTCTTTGCATAAACGAGCCCT
GTTCTAGTGCGTGCCACGGGCTACTTCGTA|AAACGAGCCCTTAACTTTAACTATCCTCTT
GGGCTGAAGCTGCAGGACGAGAACGGTTCT|CTATCCTCTTTGCATAAACGAGCCCTATAG
TACATACACTACGAAGCGGTGAGTGCAGAC|GGACGCATGGACAAGCGGCACCAGGAACCA
AGGAGTGCTTACTTGTATAGATCATTTCTC|CACGAGCGAAATGGAGTTGGGTTTCTGGCT
ATCCTCTTTGCATAAACGAGCCCTAACGCG|CGATTAACTATCCTCTTTGCATAAACGAGC
CCCGTGACCACATTACATACACTACGAAGC|AATGGCCTCATAAGGACGCATGGACAAGCG
CCCTGTTTAGTCCCTCTGATAATCCATCGG|ATAGGGAAATTAACTATCTTAACTATCCTC
ACTATCCTCTTTGCATAAACGAGCCCTCCC|TAAGGGGGCTGAAGCTGCAGGACGAGAACG
TAAACGAGCCCTCCTCTTTGCATAAACGAG|AGAACCCCACGCTCCCACTGAAAGGGTCTT
CTCTTTGCATAAACGAGCCCTCTCTTTGCA|CTTCGTAGCCCCGCCGAATCAGACGCCCAC
AACGATTAACTATCCTCTTTGCATAAACGA|TTCTCCCGCGGAATCGTTTGGGAACTTTAA
GCATAAACGAGCCCTAGCGAGTCCCGGCCT|ATTATCTTATGTCGATGGCGGCGCGCTTAA
TCGCATGGGAATGGTTCGAGCTCGTTCTAG|TAAACGAGCCCTCCTCTTTGCATAAACGAG
TAACTATTTAACTATCCTCTTTGCATAAAC|CGTACACATGCACGGCATAGCTTCTAGAAC
TTTAAGTACTGTGCCGGCACGAGCGAAATG|GTGTTTCAGACACTATTGTACGCGTGCAGC
GCATAAACGAGCCCTATACAAGTTTCCGCG|CCGCTATCCAACTTCGTATATGTCGGAGAC
AAACGAGCCCTCTCTTTGCATAAACGATTA|CCGCCGAATCAGACGCCCACGCTTCTCCCG
TCGGACATCTAACGATACTACCCATTAATT|CCTCTTTGCATAAACGAGCCCTCTCTTTGC
ATAAACGAGCCCTAGTCCCACGGCAGCAGG|TGCCCCCCGTGACCACATTACATACACTAC
CCATTCAGCCCGAGACGATTAACTATCCTC|CCTTGAGTTTACGCCGCGTCTCGCCTTCAT
CGATTAACTATCCTCTTTGCATAAACGAGC|CGCTGATAAGGGGGCTGAAGCTGCAGGACG
TAAACGAGCCCTAGTCCCACGGCAGCAGGA|GCCCCCCGTGACCACATTACATACACTACG
GTCGGAGACTCTCGCTTTAAGTACTGTGCC|CTTTAGTGCCTCTTTGTGTTTCAGACACTA
ATAAACGAGCCCTCTCTTTGCATAAACGAT|CCCCGCCGAATCAGACGCCCACGCTTCTCC
AACGAGCCCTTAACTTTAACTATCCTCTTT|GGTCTTAACTATCCTCTTTGCATAAACGAG
CTCTTTGCATAAACGAGCCCTGCGACATTG|CATAGCAGCAGACGGTGATGCAAACAATTG
GCACCAGGAACCATTAATGTTAACTATCCT|CCCTCTGATAATCCATCGGACATCTAACGA
AGTATCGCGCGCGCTAGCCAGGCAATTATT|TTAACTATCCTCTTTGCATAAACGAGCCCT
TGCTTACTTGTATAGATCATTTCTCCTCAT|GCGAAATGGAGTTGGGTTTCTGGCTCCATT
TTTAGTCCCTCTGATAATCCATCGGACATC|GAAATTAACTATCTTAACTATCCTCTTTGC
TCCCTTAAAGTATCGCGCGCGCTAGCCAGG|AACGGTTCTTAACTATCCTCTTTGCATAAA
TTTAACTATCCTCTTTGCATAAACGAGCCC|GCATAAACGATTAACTATCCTCTTTGCATA
GTGCTTACTTGTATAGATCATTTCTCCTCA|AGCGAAATGGAGTTGGGTTTCTGGCTCCAT
GTTAGTGTCGCATGGGAATGGTTCGAGCTC|CTTTGCATAAACGAGCCCTCCTCTTTGCAT
AAACGAGCCCTATACAAGTTTCCGCGTCAG|TATCCAACTTCGTATATGTCGGAGACTCTC
GTGCGTGCCACGGGCTACTTCGTAGCCCCG|GCCCTTAACTTTAACTATCCTCTTTGCATA
AACTATCCTCTTTGCATAAACGAGCCCTCT|CGGGCTACTTCGTAGCCCCGCCGAATCAGA
CTAGGCTCGATTAACTATCCTCTTTGCATA|GTGCAGACGCTGATAAGGGGGCTGAAGCTG
TAGCAACTGACAATTTCTAGGAGTGCTTAC|CTTTAAGTACTGTGCCGGCACGAGCGAAAT
AGCAACTGACAATTTCTAGGAGTGCTTACT|TTTAAGTACTGTGCCGGCACGAGCGAAATG
GCATAAACGATTAACTATCCTCTTTGCATA|CACGCTTCTCCCGCGGAATCGTTTGGGAAC
GAGCCCTATAGGAGTGTTTCCACCGATTAT|ATTTAACTATCCTCTTTGCATAAACGAGCC
CCCACGGCAGCAGGATAAAGCGGACTAGGC|ATTACATACACTACGAAGCGGTGAGTGCAG
GCCCCGCCGAATCAGACGCCCACGCTTCTC|TGCATAAACGAGCCCTATCCTCTTTGCATA
TCTTTGCATAAACGAGCCCTCCCTTAAAGT|GCTGAAGCTGCAGGACGAGAACGGTTCTTA
TGTTTAGTCCCTCTGATAATCCATCGGACA|GGGAAATTAACTATCTTAACTATCCTCTTT
TGGCCTCATAAGGACGCATGGACAAGCGGC|CTCTTTGCATAAACGAGCCCTGTTTAGTCC
ATTTAACTATCCTCTTTGCATAAACGAGCC|ACATGCACGGCATAGCTTCTAGAACCCCAC
CGGACTAGGCTCGATTAACTATCCTCTTTG|GTGAGTGCAGACGCTGATAAGGGGGCTGAA
TTGGGTTTCTGGCTCCATTCAGCCCGAGAC|TCTAAGTTCACTAACCTTGAGTTTACGCCG
CTATCCTCTTTGCATAAACGAGCCCTATAG|CTAACGATACTACCCATTAATTTAACTATC
GATCCTGCCTGTGCGCCGCTATCCAACTTC|TGCATAAACGAGCCCTGCGACATTGCTTTA
ACGCTTCTCCCGCGGAATCGTTTGGGAACT|CTTTGCATAAACGAGCCCTTGCACCCAAAC
TCTTTGCATAAACGATTAACTATCCTCTTT|ACGCCCACGCTTCTCCCGCGGAATCGTTTG
GGAAATTAACTATCTTAACTATCCTCTTTG|GTTCTAGTGCGTGCCACGGGCTACTTCGTA
AAGCGGTGAGTGCAGACGCTGATAAGGGGG|AGCGGCACCAGGAACCATTAATGTTAACTA
GAACGGTTCTTAACTATCCTCTTTGCATAA|AGCCCTATAGGAGTGTTTCCACCGATTATC
TCCACCGATTATCTTATGTCGATGGCGGCG|CATAAACGAGCCCTAACGCGCGATCTAGAC
CTTAACTTTAACTATCCTCTTTGCATAAAC|CTATCCTCTTTGCATAAACGAGCCCTATAC
GGGTTTCTGGCTCCATTCAGCCCGAGACGA|TAAGTTCACTAACCTTGAGTTTACGCCGCG
CCCTCCCTTAAAGTATCGCGCGCGCTAGCC|GAGAACGGTTCTTAACTATCCTCTTTGCAT
AACTCGTACACATGCACGGCATAGCTTCTA|TGCTTACTTGTATAGATCATTTCTCCTCAT
AGATAGCAACTGACAATTTCTAGGAGTGCT|TCGCTTTAAGTACTGTGCCGGCACGAGCGA
CCCTCCTCTTTGCATAAACGAGCCCTTAAC|ACGCTCCCACTGAAAGGGTCTTAACTATCC
TATCTTAACTATCCTCTTTGCATAAACGAG|GTGCCACGGGCTACTTCGTAGCCCCGCCGA
CTTGCACCCAAACTCGTACACATGCACGGC|TTTCTAGGAGTGCTTACTTGTATAGATCAT
TCGTATATGTCGGAGACTCTCGCTTTAAGT|TACGGCGCCTTTAGTGCCTCTTTGTGTTTC
AGCTTCTAGAACCCCACGCTCCCACTGAAA|CTCCTCATGAATTCGACAACCCAACCATAG
CTCCATTCAGCCCGAGACGATTAACTATCC|AACCTTGAGTTTACGCCGCGTCTCGCCTTC
AAGTATCGCGCGCGCTAGCCAGGCAATTAT|CTTAACTATCCTCTTTGCATAAACGAGCCC
TGCATAAACGATTAACTATCCTCTTTGCAT|CCACGCTTCTCCCGCGGAATCGTTTGGGAA
ATGTCGGAGACTCTCGCTTTAAGTACTGTG|GCCTTTAGTGCCTCTTTGTGTTTCAGACAC
CGCATGGACAAGCGGCACCAGGAACCATTA|GAGCCCTGTTTAGTCCCTCTGATAATCCAT
TTCCGCGTCAGATAGCAACTGACAATTTCT|CGGAGACTCTCGCTTTAAGTACTGTGCCGG
CTTAACTATCCTCTTTGCATAAACGAGCCC|CCACGGGCTACTTCGTAGCCCCGCCGAATC
GGTGAGTGCAGACGCTGATAAGGGGGCTGA|GCACCAGGAACCATTAATGTTAACTATCCT
TGGACAAGCGGCACCAGGAACCATTAATGT|CCTGTTTAGTCCCTCTGATAATCCATCGGA
TTCTGGCTCCATTCAGCCCGAGACGATTAA|TTCACTAACCTTGAGTTTACGCCGCGTCTC
AACGAGCCCTCCCTTAAAGTATCGCGCGCG|CAGGACGAGAACGGTTCTTAACTATCCTCT
AAACGAGCCCTAACGCGCGATCTAGACGGT|TCTTTGCATAAACGAGCCCTGCCCTCTTAC
ACGAGCCCTCTCTTTGCATAAACGATTAAC|GCCGAATCAGACGCCCACGCTTCTCCCGCG
CATTAATTTAACTATCCTCTTTGCATAAAC|CTCTTTGCATAAACGATTAACTATCCTCTT
GCTTTAAGTACTGTGCCGGCACGAGCGAAA|TTGTGTTTCAGACACTATTGTACGCGTGCA
ATGGCCTCATAAGGACGCATGGACAAGCGG|CCTCTTTGCATAAACGAGCCCTGTTTAGTC
CCTCTTTGCATAAACGAGCCCTATAGGAGT|CGATACTACCCATTAATTTAACTATCCTCT
TAACTATCCTCTTTGCATAAACGAGCCCTC|TGCACGGCATAGCTTCTAGAACCCCACGCT
CAGCCCGAGACGATTAACTATCCTCTTTGC|AGTTTACGCCGCGTCTCGCCTTCATAGCAG
GGGTCTTAACTATCCTCTTTGCATAAACGA|CGGAAGATCCTGCCTGTGCGCCGCTATCCA
AGTGCTTACTTGTATAGATCATTTCTCCTC|GAGCGAAATGGAGTTGGGTTTCTGGCTCCA
CGCCTTTAGTGCCTCTTTGTGTTTCAGACA|TTAGTACACCATGACCCGCTAGCAATCAGT
CTGTTTAGTCCCTCTGATAATCCATCGGAC|AGGGAAATTAACTATCTTAACTATCCTCTT
AAGCGGCACCAGGAACCATTAATGTTAACT|TTAGTCCCTCTGATAATCCATCGGACATCT
ATTAACTATCTTAACTATCCTCTTTGCATA|TAGTGCGTGCCACGGGCTACTTCGTAGCCC
GAGCCCTAGTCCCACGGCAGCAGGATAAAG|CCGTGACCACATTACATACACTACGAAGCG
CTTTAGTGCCTCTTTGTGTTTCAGACACTA|GTACACCATGACCCGCTAGCAATCAGTAAA
TAGTGCGTGCCACGGGCTACTTCGTAGCCC|GAGCCCTTAACTTTAACTATCCTCTTTGCA
TTATGTCGATGGCGGCGCGCTTAACTATCC|TAACGCGCGATCTAGACGGTACAACTCGGC
CTTTACGGCGCCTTTAGTGCCTCTTTGTGT|GCCTGTCCTTAGTACACCATGACCCGCTAG
GACGCTGATAAGGGGGCTGAAGCTGCAGGA|CCATTAATGTTAACTATCCTCTTTGCATAA
TCGCGCGCGCTAGCCAGGCAATTATTTCGT|CTATCCTCTTTGCATAAACGAGCCCTAGCG
GGCTACTTCGTAGCCCCGCCGAATCAGACG|AACTATCCTCTTTGCATAAACGAGCCCTAT
GAGCCCTGCCCTCTTACGTTAGTGTCGCAT|AACTATTTAACTATCCTCTTTGCATAAACG
ACCACGATGCCCCCCGTGACCACATTACAT|TCCCGGCCTCTAAATGGCCTCATAAGGACG
ATCCTCTTTGCATAAACGAGCCCTGCCCTC|AATCGTTTGGGAACTTTAACTATTTAACTA
GATAATCCATCGGACATCTAACGATACTAC|CTTAACTATCCTCTTTGCATAAACGAGCCC
TATCCAACTTCGTATATGTCGGAGACTCTC|ACATTGCTTTACGGCGCCTTTAGTGCCTCT
GAGCGAAATGGAGTTGGGTTTCTGGCTCCA|CGCGTGCAGCCGATCTAAGTTCACTAACCT
CCTCTTTGCATAAACGAGCCCTCTCTTTGC|ACTTCGTAGCCCCGCCGAATCAGACGCCCA
GATAGCAACTGACAATTTCTAGGAGTGCTT|CGCTTTAAGTACTGTGCCGGCACGAGCGAA
CGGCACCAGGAACCATTAATGTTAACTATC|GTCCCTCTGATAATCCATCGGACATCTAAC
CAACTTCGTATATGTCGGAGACTCTCGCTT|TGCTTTACGGCGCCTTTAGTGCCTCTTTGT
TAATGTTAACTATCCTCTTTGCATAAACGA|ATCGGACATCTAACGATACTACCCATTAAT
AACGAGCCCTTGCACCCAAACTCGTACACA|ACTGACAATTTCTAGGAGTGCTTACTTGTA
CAGACGCTGATAAGGGGGCTGAAGCTGCAG|AACCATTAATGTTAACTATCCTCTTTGCAT
TGCGACATTGCTTTACGGCGCCTTTAGTGC|CAAACAATTGGCCTGTCCTTAGTACACCAT
ATAGCGGAAGATCCTGCCTGTGCGCCGCTA|TATCCTCTTTGCATAAACGAGCCCTGCGAC
TGCACCACGATGCCCCCCGTGACCACATTA|GAGTCCCGGCCTCTAAATGGCCTCATAAGG
AGCGACGAAGCTTAACTATCCTCTTTGCAT|AGCCAGGCAATTATTTCGTGCACCACGATG
ATAAACGAGCCCTTAACTTTAACTATCCTC|AAGGGTCTTAACTATCCTCTTTGCATAAAC
ATCCTCTTTGCATAAACGAGCCCTAGCGAG|TTTCCACCGATTATCTTATGTCGATGGCGG
GAAGCTTAACTATCCTCTTTGCATAAACGA|GCAATTATTTCGTGCACCACGATGCCCCCC
TTGCACCCAAACTCGTACACATGCACGGCA|TTCTAGGAGTGCTTACTTGTATAGATCATT
TAGTCCCACGGCAGCAGGATAAAGCGGACT|CCACATTACATACACTACGAAGCGGTGAGT
GATAAAGCGGACTAGGCTCGATTAACTATC|CGAAGCGGTGAGTGCAGACGCTGATAAGGG
AGCCCTTAACTTTAACTATCCTCTTTGCAT|TTAACTATCCTCTTTGCATAAACGAGCCCT
CTTTAACTATTTAACTATCCTCTTTGCATA|ACTCGTACACATGCACGGCATAGCTTCTAG
TTTCGTGCACCACGATGCCCCCCGTGACCA|CTAGCGAGTCCCGGCCTCTAAATGGCCTCA
GCGGTGAGTGCAGACGCTGATAAGGGGGCT|CGGCACCAGGAACCATTAATGTTAACTATC
AATTCGACAACCCAACCATAGCGGAAGATC|AGCCCGAGACGATTAACTATCCTCTTTGCA
GAGCCCTCTCTTTGCATAAACGATTAACTA|CGAATCAGACGCCCACGCTTCTCCCGCGGA
GGATAAAGCGGACTAGGCTCGATTAACTAT|ACGAAGCGGTGAGTGCAGACGCTGATAAGG
AAAGCGACGAAGCTTAACTATCCTCTTTGC|CTAGCCAGGCAATTATTTCGTGCACCACGA
AGTGCAGACGCTGATAAGGGGGCTGAAGCT|CAGGAACCATTAATGTTAACTATCCTCTTT
GCTGCAGGACGAGAACGGTTCTTAACTATC|TTTGCATAAACGAGCCCTATAGGAGTGTTT
GCCCCCCGTGACCACATTACATACACTACG|TCTAAATGGCCTCATAAGGACGCATGGACA
CGGCACGAGCGAAATGGAGTTGGGTTTCTG|ATTGTACGCGTGCAGCCGATCTAAGTTCAC
CAACTCGGCGGAGCGGAACTCGCTAATAGG|TTAGTGTCGCATGGGAATGGTTCGAGCTCG
TCTTTGCATAAACGAGCCCTTAACTTTAAC|CCACTGAAAGGGTCTTAACTATCCTCTTTG
CCCTTAAAGTATCGCGCGCGCTAGCCAGGC|ACGGTTCTTAACTATCCTCTTTGCATAAAC
CTTTGCATAAACGAGCCCTGCCCTCTTACG|TTTGGGAACTTTAACTATTTAACTATCCTC
CTTAAAGTATCGCGCGCGCTAGCCAGGCAA|GGTTCTTAACTATCCTCTTTGCATAAACGA
AGTGCGTGCCACGGGCTACTTCGTAGCCCC|AGCCCTTAACTTTAACTATCCTCTTTGCAT
CGCTTAACTATCCTCTTTGCATAAACGAGC|GGTACAACTCGGCGGAGCGGAACTCGCTAA
ACTATCCTCTTTGCATAAACGAGCCCTATA|CCTGCCTGTGCGCCGCTATCCAACTTCGTA
TGCCGGCACGAGCGAAATGGAGTTGGGTTT|ACTATTGTACGCGTGCAGCCGATCTAAGTT
CTTTGCATAAACGAGCCCTATACAAGTTTC|TGCGCCGCTATCCAACTTCGTATATGTCGG
TTGCATAAACGAGCCCTCTCTTTGCATAAA|GTAGCCCCGCCGAATCAGACGCCCACGCTT
TTATTTCGTGCACCACGATGCCCCCCGTGA|GCCCTAGCGAGTCCCGGCCTCTAAATGGCC
CTCATAAGGACGCATGGACAAGCGGCACCA|TTGCATAAACGAGCCCTGTTTAGTCCCTCT
AGCCCTGTTTAGTCCCTCTGATAATCCATC|TAATAGGGAAATTAACTATCTTAACTATCC
CGCGCGATCTAGACGGTACAACTCGGCGGA|GAGCCCTGCCCTCTTACGTTAGTGTCGCAT
ATAAACGAGCCCTATAGGAGTGTTTCCACC|CCATTAATTTAACTATCCTCTTTGCATAAA
AGACGCTGATAAGGGGGCTGAAGCTGCAGG|ACCATTAATGTTAACTATCCTCTTTGCATA
CGCGTCAGATAGCAACTGACAATTTCTAGG|AGACTCTCGCTTTAAGTACTGTGCCGGCAC
TCGTTCTAGTGCGTGCCACGGGCTACTTCG|ATAAACGAGCCCTTAACTTTAACTATCCTC
GCTTAACTATCCTCTTTGCATAAACGAGCC|GTACAACTCGGCGGAGCGGAACTCGCTAAT
AGGGTCTTAACTATCCTCTTTGCATAAACG|GCGGAAGATCCTGCCTGTGCGCCGCTATCC
TTTGCATAAACGAGCCCTTAACTTTAACTA|ACTGAAAGGGTCTTAACTATCCTCTTTGCA
TCCTCTTTGCATAAACGAGCCCTGCGACAT|TTCATAGCAGCAGACGGTGATGCAAACAAT
CCTCTTACGTTAGTGTCGCATGGGAATGGT|ACTATCCTCTTTGCATAAACGAGCCCTCCT
CTCGTTCTAGTGCGTGCCACGGGCTACTTC|CATAAACGAGCCCTTAACTTTAACTATCCT
GCATGGACAAGCGGCACCAGGAACCATTAA|AGCCCTGTTTAGTCCCTCTGATAATCCATC
ACTATCTTAACTATCCTCTTTGCATAAACG|GCGTGCCACGGGCTACTTCGTAGCCCCGCC
CCTCTTTGCATAAACGAGCCCTATACAAGT|CTGTGCGCCGCTATCCAACTTCGTATATGT
ACTATCCTCTTTGCATAAACGAGCCCTAGT|TTCGTGCACCACGATGCCCCCCGTGACCAC
AACTATCCTCTTTGCATAAACGAGCCCTAT|TTGCATAAACGAGCCCTATACAAGTTTCCG
GGCTCCATTCAGCCCGAGACGATTAACTAT|CTAACCTTGAGTTTACGCCGCGTCTCGCCT
TGTCAACAATCCTACGAAAGCGACGAAGCT|TAAAGTATCGCGCGCGCTAGCCAGGCAATT
GCGGAACTCGCTAATAGGGAAATTAACTAT|GGGAATGGTTCGAGCTCGTTCTAGTGCGTG
CTATCTTAACTATCCTCTTTGCATAAACGA|CGTGCCACGGGCTACTTCGTAGCCCCGCCG
ACGGGCTACTTCGTAGCCCCGCCGAATCAG|TTTAACTATCCTCTTTGCATAAACGAGCCC
GGAGACTCTCGCTTTAAGTACTGTGCCGGC|TAGTGCCTCTTTGTGTTTCAGACACTATTG
CTCTTTGCATAAACGAGCCCTAGCGAGTCC|CCACCGATTATCTTATGTCGATGGCGGCGC
GCCCTAGTCCCACGGCAGCAGGATAAAGCG|GTGACCACATTACATACACTACGAAGCGGT
AAACGATTAACTATCCTCTTTGCATAAACG|CTTCTCCCGCGGAATCGTTTGGGAACTTTA
GAGTCCCGGCCTCTAAATGGCCTCATAAGG|CGGCGCGCTTAACTATCCTCTTTGCATAAA
AACAATCCTACGAAAGCGACGAAGCTTAAC|GTATCGCGCGCGCTAGCCAGGCAATTATTT
CTAGGAGTGCTTACTTGTATAGATCATTTC|GGCACGAGCGAAATGGAGTTGGGTTTCTGG
CCCTGCCCTCTTACGTTAGTGTCGCATGGG|TATTTAACTATCCTCTTTGCATAAACGAGC
TTACGGCGCCTTTAGTGCCTCTTTGTGTTT|CTGTCCTTAGTACACCATGACCCGCTAGCA
GCTGAAGCTGCAGGACGAGAACGGTTCTTA|ATCCTCTTTGCATAAACGAGCCCTATAGGA
CTCCTCTTTGCATAAACGAGCCCTTAACTT|GCTCCCACTGAAAGGGTCTTAACTATCCTC
GAATGGTTCGAGCTCGTTCTAGTGCGTGCC|CCCTCCTCTTTGCATAAACGAGCCCTTAAC
GTTTCTGGCTCCATTCAGCCCGAGACGATT|AGTTCACTAACCTTGAGTTTACGCCGCGTC
TCCCTCTGATAATCCATCGGACATCTAACG|TAACTATCTTAACTATCCTCTTTGCATAAA
CATAAACGAGCCCTCCCTTAAAGTATCGCG|GCTGCAGGACGAGAACGGTTCTTAACTATC
CACTACGAAGCGGTGAGTGCAGACGCTGAT|ATGGACAAGCGGCACCAGGAACCATTAATG
AATTAACTATCTTAACTATCCTCTTTGCAT|CTAGTGCGTGCCACGGGCTACTTCGTAGCC
CTATAGGAGTGTTTCCACCGATTATCTTAT|ACTATCCTCTTTGCATAAACGAGCCCTAAC
CTATCCTCTTTGCATAAACGAGCCCTAGTC|TCGTGCACCACGATGCCCCCCGTGACCACA
GCACGGCATAGCTTCTAGAACCCCACGCTC|AGATCATTTCTCCTCATGAATTCGACAACC
CCTCATAAGGACGCATGGACAAGCGGCACC|TTTGCATAAACGAGCCCTGTTTAGTCCCTC
GCCCTTAACTTTAACTATCCTCTTTGCATA|TAACTATCCTCTTTGCATAAACGAGCCCTA
ACTATCCTCTTTGCATAAACGAGCCCTAAC|AAACGATTAACTATCCTCTTTGCATAAACG
TGCTTTACGGCGCCTTTAGTGCCTCTTTGT|TGGCCTGTCCTTAGTACACCATGACCCGCT
ATGGCGGCGCGCTTAACTATCCTCTTTGCA|GATCTAGACGGTACAACTCGGCGGAGCGGA
TTGCATAAACGAGCCCTAGCGAGTCCCGGC|CGATTATCTTATGTCGATGGCGGCGCGCTT
CTACGAAGCGGTGAGTGCAGACGCTGATAA|GGACAAGCGGCACCAGGAACCATTAATGTT
CGAGCCCTATCCTCTTTGCATAAACGAGCC|CAAGTTTCCGCGTCAGATAGCAACTGACAA
ACGAGCCCTTGCACCCAAACTCGTACACAT|CTGACAATTTCTAGGAGTGCTTACTTGTAT
TTGGGAACTTTAACTATTTAACTATCCTCT|CACCCAAACTCGTACACATGCACGGCATAG
GCAGGATAAAGCGGACTAGGCTCGATTAAC|ACTACGAAGCGGTGAGTGCAGACGCTGATA
CTATCCTCTTTGCATAAACGAGCCCTAACG|AACGATTAACTATCCTCTTTGCATAAACGA
TGAAGCTGCAGGACGAGAACGGTTCTTAAC|CCTCTTTGCATAAACGAGCCCTATAGGAGT
TGGGAACTTTAACTATTTAACTATCCTCTT|ACCCAAACTCGTACACATGCACGGCATAGC
ACGGTACAACTCGGCGGAGCGGAACTCGCT|CTTACGTTAGTGTCGCATGGGAATGGTTCG
CTAGAACCCCACGCTCCCACTGAAAGGGTC|CATGAATTCGACAACCCAACCATAGCGGAA
ATCCTCTTTGCATAAACGAGCCCTCCTCTT|GGCATAGCTTCTAGAACCCCACGCTCCCAC
CCACGGGCTACTTCGTAGCCCCGCCGAATC|ACTTTAACTATCCTCTTTGCATAAACGAGC
ACGCGCGATCTAGACGGTACAACTCGGCGG|CGAGCCCTGCCCTCTTACGTTAGTGTCGCA
ATTAACTATCCTCTTTGCATAAACGAGCCC|CTGATAAGGGGGCTGAAGCTGCAGGACGAG
TCCTCTTTGCATAAACGAGCCCTATCCTCT|TAAACGAGCCCTATACAAGTTTCCGCGTCA
GTACACATGCACGGCATAGCTTCTAGAACC|ACTTGTATAGATCATTTCTCCTCATGAATT
TCTCCTCATGAATTCGACAACCCAACCATA|GGCTCCATTCAGCCCGAGACGATTAACTAT
CATAAACGAGCCCTGCCCTCTTACGTTAGT|GAACTTTAACTATTTAACTATCCTCTTTGC
GATACTACCCATTAATTTAACTATCCTCTT|ACGAGCCCTCTCTTTGCATAAACGATTAAC
CCTCTTTGCATAAACGAGCCCTGTTTAGTC|GCGGAGCGGAACTCGCTAATAGGGAAATTA
ATAAACGAGCCCTGTTTAGTCCCTCTGATA|AACTCGCTAATAGGGAAATTAACTATCTTA
AGCGGTGAGTGCAGACGCTGATAAGGGGGC|GCGGCACCAGGAACCATTAATGTTAACTAT
AGACGATTAACTATCCTCTTTGCATAAACG|GCCGCGTCTCGCCTTCATAGCAGCAGACGG
AACGAGCCCTAACGCGCGATCTAGACGGTA|CTTTGCATAAACGAGCCCTGCCCTCTTACG
CGAGCCCTCCTCTTTGCATAAACGAGCCCT|CCCCACGCTCCCACTGAAAGGGTCTTAACT
CCCACGCTCCCACTGAAAGGGTCTTAACTA|TCGACAACCCAACCATAGCGGAAGATCCTG
TTTAACTATCCTCTTTGCATAAACGAGCCC|CATGCACGGCATAGCTTCTAGAACCCCACG
ACTATCCTCTTTGCATAAACGAGCCCTCCT|CACGGCATAGCTTCTAGAACCCCACGCTCC
AACTATCTTAACTATCCTCTTTGCATAAAC|TGCGTGCCACGGGCTACTTCGTAGCCCCGC
AAGATCCTGCCTGTGCGCCGCTATCCAACT|TTTGCATAAACGAGCCCTGCGACATTGCTT
TGCAGGACGAGAACGGTTCTTAACTATCCT|TGCATAAACGAGCCCTATAGGAGTGTTTCC
GCCCTGCCCTCTTACGTTAGTGTCGCATGG|CTATTTAACTATCCTCTTTGCATAAACGAG
GTCCCGGCCTCTAAATGGCCTCATAAGGAC|GCGCGCTTAACTATCCTCTTTGCATAAACG
TTAACTATTTAACTATCCTCTTTGCATAAA|TCGTACACATGCACGGCATAGCTTCTAGAA
CATAAACGAGCCCTATCCTCTTTGCATAAA|CCTATACAAGTTTCCGCGTCAGATAGCAAC
TTGCTTTACGGCGCCTTTAGTGCCTCTTTG|TTGGCCTGTCCTTAGTACACCATGACCCGC
CTCTTTGCATAAACGAGCCCTGTTTAGTCC|CGGAGCGGAACTCGCTAATAGGGAAATTAA
ATTTCTAGGAGTGCTTACTTGTATAGATCA|TGCCGGCACGAGCGAAATGGAGTTGGGTTT
TTGCATAAACGAGCCCTCCTCTTTGCATAA|CTTCTAGAACCCCACGCTCCCACTGAAAGG
CCCGCCGAATCAGACGCCCACGCTTCTCCC|CATAAACGAGCCCTATCCTCTTTGCATAAA
AAGGGGGCTGAAGCTGCAGGACGAGAACGG|TTAACTATCCTCTTTGCATAAACGAGCCCT
TTAACTATCCTCTTTGCATAAACGAGCCCT|ACATCTAACGATACTACCCATTAATTTAAC
TACTTCGTAGCCCCGCCGAATCAGACGCCC|TATCCTCTTTGCATAAACGAGCCCTATCCT
ATCCTACGAAAGCGACGAAGCTTAACTATC|CGCGCGCGCTAGCCAGGCAATTATTTCGTG
TCGTAGCCCCGCCGAATCAGACGCCCACGC|CTCTTTGCATAAACGAGCCCTATCCTCTTT
GACGAGAACGGTTCTTAACTATCCTCTTTG|AAACGAGCCCTATAGGAGTGTTTCCACCGA
GAGAACGGTTCTTAACTATCCTCTTTGCAT|CGAGCCCTATAGGAGTGTTTCCACCGATTA
ACGAGCCCTGTTTAGTCCCTCTGATAATCC|CGCTAATAGGGAAATTAACTATCTTAACTA
CGTCAGATAGCAACTGACAATTTCTAGGAG|ACTCTCGCTTTAAGTACTGTGCCGGCACGA
ACAATCCTACGAAAGCGACGAAGCTTAACT|TATCGCGCGCGCTAGCCAGGCAATTATTTC
CTTTGCATAAACGAGCCCTAGCGAGTCCCG|ACCGATTATCTTATGTCGATGGCGGCGCGC
AGATCCTGCCTGTGCGCCGCTATCCAACTT|TTGCATAAACGAGCCCTGCGACATTGCTTT
TATCCTCTTTGCATAAACGAGCCCTGCGAC|CCTTCATAGCAGCAGACGGTGATGCAAACA
TTAACTATCCTCTTTGCATAAACGAGCCCT|ATGCACGGCATAGCTTCTAGAACCCCACGC
CTTTGCATAAACGAGCCCTAACGCGCGATC|AACTATCCTCTTTGCATAAACGAGCCCTGC
CCATCGGACATCTAACGATACTACCCATTA|TATCCTCTTTGCATAAACGAGCCCTCTCTT
GCCCTAACGCGCGATCTAGACGGTACAACT|CATAAACGAGCCCTGCCCTCTTACGTTAGT
AGAACGGTTCTTAACTATCCTCTTTGCATA|GAGCCCTATAGGAGTGTTTCCACCGATTAT
GCATAAACGAGCCCTCCCTTAAAGTATCGC|AGCTGCAGGACGAGAACGGTTCTTAACTAT
GACATCTAACGATACTACCCATTAATTTAA|CTTTGCATAAACGAGCCCTCTCTTTGCATA
GAGCCCTATCCTCTTTGCATAAACGAGCCC|AAGTTTCCGCGTCAGATAGCAACTGACAAT
GGCGCCTTTAGTGCCTCTTTGTGTTTCAGA|CCTTAGTACACCATGACCCGCTAGCAATCA
TCGTGCACCACGATGCCCCCCGTGACCACA|AGCGAGTCCCGGCCTCTAAATGGCCTCATA
AGTTGGGTTTCTGGCTCCATTCAGCCCGAG|GATCTAAGTTCACTAACCTTGAGTTTACGC
TGTGCCGGCACGAGCGAAATGGAGTTGGGT|ACACTATTGTACGCGTGCAGCCGATCTAAG
GCCCTATACAAGTTTCCGCGTCAGATAGCA|ACTTCGTATATGTCGGAGACTCTCGCTTTA
ATCTAACGATACTACCCATTAATTTAACTA|TGCATAAACGAGCCCTCTCTTTGCATAAAC
AAAGTATCGCGCGCGCTAGCCAGGCAATTA|TCTTAACTATCCTCTTTGCATAAACGAGCC
CGAGCCCTGCGACATTGCTTTACGGCGCCT|GGTGATGCAAACAATTGGCCTGTCCTTAGT
TGAGTGCAGACGCTGATAAGGGGGCTGAAG|ACCAGGAACCATTAATGTTAACTATCCTCT
GGCCTCTAAATGGCCTCATAAGGACGCATG|CTTAACTATCCTCTTTGCATAAACGAGCCC
TTGCATAAACGAGCCCTATAGGAGTGTTTC|CTACCCATTAATTTAACTATCCTCTTTGCA
GAGTGCTTACTTGTATAGATCATTTCTCCT|CGAGCGAAATGGAGTTGGGTTTCTGGCTCC
CACGCTTCTCCCGCGGAATCGTTTGGGAAC|TCTTTGCATAAACGAGCCCTTGCACCCAAA
ACGAGAACGGTTCTTAACTATCCTCTTTGC|AACGAGCCCTATAGGAGTGTTTCCACCGAT
ACTTCGTAGCCCCGCCGAATCAGACGCCCA|ATCCTCTTTGCATAAACGAGCCCTATCCTC
TATCCTCTTTGCATAAACGAGCCCTATACA|TGCCTGTGCGCCGCTATCCAACTTCGTATA
CCTCATGAATTCGACAACCCAACCATAGCG|TCCATTCAGCCCGAGACGATTAACTATCCT
AAGGACGCATGGACAAGCGGCACCAGGAAC|TAAACGAGCCCTGTTTAGTCCCTCTGATAA
TTTAGTGCCTCTTTGTGTTTCAGACACTAT|TACACCATGACCCGCTAGCAATCAGTAAAG
GCGACGAAGCTTAACTATCCTCTTTGCATA|GCCAGGCAATTATTTCGTGCACCACGATGC
GCCCTATCCTCTTTGCATAAACGAGCCCTT|GTTTCCGCGTCAGATAGCAACTGACAATTT
TTTAACTATCCTCTTTGCATAAACGAGCCC|TCTTTGCATAAACGAGCCCTATACAAGTTT
AACGAGCCCTATCCTCTTTGCATAAACGAG|TACAAGTTTCCGCGTCAGATAGCAACTGAC
TGGTTCGAGCTCGTTCTAGTGCGTGCCACG|TCCTCTTTGCATAAACGAGCCCTTAACTTT
TTCTTAACTATCCTCTTTGCATAAACGAGC|ATAGGAGTGTTTCCACCGATTATCTTATGT
TCTTTGCATAAACGAGCCCTAGCGAGTCCC|CACCGATTATCTTATGTCGATGGCGGCGCG
CCGCCGAATCAGACGCCCACGCTTCTCCCG|ATAAACGAGCCCTATCCTCTTTGCATAAAC
CGATGGCGGCGCGCTTAACTATCCTCTTTG|GCGATCTAGACGGTACAACTCGGCGGAGCG
TCTCCCGCGGAATCGTTTGGGAACTTTAAC|CATAAACGAGCCCTTGCACCCAAACTCGTA
GAATCAGACGCCCACGCTTCTCCCGCGGAA|CGAGCCCTATCCTCTTTGCATAAACGAGCC
CGAGCCCTAGTCCCACGGCAGCAGGATAAA|CCCGTGACCACATTACATACACTACGAAGC
CGTGCACCACGATGCCCCCCGTGACCACAT|GCGAGTCCCGGCCTCTAAATGGCCTCATAA
CCACGGCAGCAGGATAAAGCGGACTAGGCT|TTACATACACTACGAAGCGGTGAGTGCAGA
GCAGGACGAGAACGGTTCTTAACTATCCTC|GCATAAACGAGCCCTATAGGAGTGTTTCCA
GTCAGATAGCAACTGACAATTTCTAGGAGT|CTCTCGCTTTAAGTACTGTGCCGGCACGAG
GCGCGCTTAACTATCCTCTTTGCATAAACG|GACGGTACAACTCGGCGGAGCGGAACTCGC
TCCAACTTCGTATATGTCGGAGACTCTCGC|ATTGCTTTACGGCGCCTTTAGTGCCTCTTT
CATAAACGAGCCCTAGCGAGTCCCGGCCTC|TTATCTTATGTCGATGGCGGCGCGCTTAAC
CCTCTTTGCATAAACGAGCCCTTGCACCCA|CGTCAGATAGCAACTGACAATTTCTAGGAG
GCTTACTTGTATAGATCATTTCTCCTCATG|CGAAATGGAGTTGGGTTTCTGGCTCCATTC
GCGCCGCTATCCAACTTCGTATATGTCGGA|CCCTGCGACATTGCTTTACGGCGCCTTTAG
GCAACTGACAATTTCTAGGAGTGCTTACTT|TTAAGTACTGTGCCGGCACGAGCGAAATGG
CTCTTTGCATAAACGATTAACTATCCTCTT|GACGCCCACGCTTCTCCCGCGGAATCGTTT
AACTATCCTCTTTGCATAAACGAGCCCTAG|AGTGTTTCCACCGATTATCTTATGTCGATG
CATAAACGAGCCCTGTTTAGTCCCTCTGAT|GAACTCGCTAATAGGGAAATTAACTATCTT
TGCCACGGGCTACTTCGTAGCCCCGCCGAA|TAACTTTAACTATCCTCTTTGCATAAACGA
ATGCCCCCCGTGACCACATTACATACACTA|CCTCTAAATGGCCTCATAAGGACGCATGGA
TTAACTATCCTCTTTGCATAAACGAGCCCT|CTTTGCATAAACGAGCCCTATACAAGTTTC
CTATCCTCTTTGCATAAACGAGCCCTGCGA|GCCTTCATAGCAGCAGACGGTGATGCAAAC
TCCTCTTTGCATAAACGAGCCCTCTCTTTG|TACTTCGTAGCCCCGCCGAATCAGACGCCC
CGGCGCCTTTAGTGCCTCTTTGTGTTTCAG|TCCTTAGTACACCATGACCCGCTAGCAATC
TTACATACACTACGAAGCGGTGAGTGCAGA|AGGACGCATGGACAAGCGGCACCAGGAACC
TATGTCGGAGACTCTCGCTTTAAGTACTGT|CGCCTTTAGTGCCTCTTTGTGTTTCAGACA
GTTGGGTTTCTGGCTCCATTCAGCCCGAGA|ATCTAAGTTCACTAACCTTGAGTTTACGCC
GAGCCCTAACGCGCGATCTAGACGGTACAA|TGCATAAACGAGCCCTGCCCTCTTACGTTA
GGACTAGGCTCGATTAACTATCCTCTTTGC|TGAGTGCAGACGCTGATAAGGGGGCTGAAG
CTGCGACATTGCTTTACGGCGCCTTTAGTG|GCAAACAATTGGCCTGTCCTTAGTACACCA
ACAACCCAACCATAGCGGAAGATCCTGCCT|AGACGATTAACTATCCTCTTTGCATAAACG
GTACAACTCGGCGGAGCGGAACTCGCTAAT|ACGTTAGTGTCGCATGGGAATGGTTCGAGC
GCCCTTGCACCCAAACTCGTACACATGCAC|CAATTTCTAGGAGTGCTTACTTGTATAGAT
AGCCCTCTCTTTGCATAAACGATTAACTAT|GAATCAGACGCCCACGCTTCTCCCGCGGAA
CATGGACAAGCGGCACCAGGAACCATTAAT|GCCCTGTTTAGTCCCTCTGATAATCCATCG
GGACGAGAACGGTTCTTAACTATCCTCTTT|TAAACGAGCCCTATAGGAGTGTTTCCACCG
CATAAACGAGCCCTAACGCGCGATCTAGAC|TCCTCTTTGCATAAACGAGCCCTGCCCTCT
CCGCTATCCAACTTCGTATATGTCGGAGAC|TGCGACATTGCTTTACGGCGCCTTTAGTGC
CTTTGCATAAACGAGCCCTGTTTAGTCCCT|GAGCGGAACTCGCTAATAGGGAAATTAACT
GCATGGGAATGGTTCGAGCTCGTTCTAGTG|AACGAGCCCTCCTCTTTGCATAAACGAGCC
CTTATGTCGATGGCGGCGCGCTTAACTATC|CTAACGCGCGATCTAGACGGTACAACTCGG
TTCTAGAACCCCACGCTCCCACTGAAAGGG|CTCATGAATTCGACAACCCAACCATAGCGG
ATTGCTTTACGGCGCCTTTAGTGCCTCTTT|ATTGGCCTGTCCTTAGTACACCATGACCCG
TACGAAGCGGTGAGTGCAGACGCTGATAAG|GACAAGCGGCACCAGGAACCATTAATGTTA
TTTGCATAAACGAGCCCTATAGGAGTGTTT|ACTACCCATTAATTTAACTATCCTCTTTGC
TTTGCATAAACGAGCCCTATACAAGTTTCC|GCGCCGCTATCCAACTTCGTATATGTCGGA
CATAAGGACGCATGGACAAGCGGCACCAGG|GCATAAACGAGCCCTGTTTAGTCCCTCTGA
CGGAGACTCTCGCTTTAAGTACTGTGCCGG|TTAGTGCCTCTTTGTGTTTCAGACACTATT
ACCCAACCATAGCGGAAGATCCTGCCTGTG|CGATTAACTATCCTCTTTGCATAAACGAGC
GAACCATTAATGTTAACTATCCTCTTTGCA|ATAATCCATCGGACATCTAACGATACTACC
GCACCACGATGCCCCCCGTGACCACATTAC|AGTCCCGGCCTCTAAATGGCCTCATAAGGA
TACGGCGCCTTTAGTGCCTCTTTGTGTTTC|TGTCCTTAGTACACCATGACCCGCTAGCAA
TATACAAGTTTCCGCGTCAGATAGCAACTG|CGTATATGTCGGAGACTCTCGCTTTAAGTA
GGACAAGCGGCACCAGGAACCATTAATGTT|CTGTTTAGTCCCTCTGATAATCCATCGGAC
CCTCTTTGCATAAACGAGCCCTAACGCGCG|ATTAACTATCCTCTTTGCATAAACGAGCCC
GCCCTCTCTTTGCATAAACGATTAACTATC|AATCAGACGCCCACGCTTCTCCCGCGGAAT
CATGCACGGCATAGCTTCTAGAACCCCACG|TATAGATCATTTCTCCTCATGAATTCGACA
GCGCTTAACTATCCTCTTTGCATAAACGAG|CGGTACAACTCGGCGGAGCGGAACTCGCTA
CGTACACATGCACGGCATAGCTTCTAGAAC|TACTTGTATAGATCATTTCTCCTCATGAAT
ACGGCAGCAGGATAAAGCGGACTAGGCTCG|ACATACACTACGAAGCGGTGAGTGCAGACG
TAGGCTCGATTAACTATCCTCTTTGCATAA|TGCAGACGCTGATAAGGGGGCTGAAGCTGC
CATTGCTTTACGGCGCCTTTAGTGCCTCTT|AATTGGCCTGTCCTTAGTACACCATGACCC
CTCTTTGCATAAACGAGCCCTTAACTTTAA|CCCACTGAAAGGGTCTTAACTATCCTCTTT
TCTTTGCATAAACGAGCCCTCCTCTTTGCA|TAGCTTCTAGAACCCCACGCTCCCACTGAA
ATCATTTCTCCTCATGAATTCGACAACCCA|GTTTCTGGCTCCATTCAGCCCGAGACGATT
TATCCTCTTTGCATAAACGAGCCCTAACGC|ACGATTAACTATCCTCTTTGCATAAACGAG
AGTGTTTCCACCGATTATCTTATGTCGATG|TCTTTGCATAAACGAGCCCTAACGCGCGAT
TACGAAAGCGACGAAGCTTAACTATCCTCT|CGCGCTAGCCAGGCAATTATTTCGTGCACC
CTTTGCATAAACGAGCCCTTGCACCCAAAC|CAGATAGCAACTGACAATTTCTAGGAGTGC
GCCCGAGACGATTAACTATCCTCTTTGCAT|TTTACGCCGCGTCTCGCCTTCATAGCAGCA
AGCGGACTAGGCTCGATTAACTATCCTCTT|CGGTGAGTGCAGACGCTGATAAGGGGGCTG
ATGCACGGCATAGCTTCTAGAACCCCACGC|ATAGATCATTTCTCCTCATGAATTCGACAA
GTGCGCCGCTATCCAACTTCGTATATGTCG|AGCCCTGCGACATTGCTTTACGGCGCCTTT
CCTTGCACCCAAACTCGTACACATGCACGG|ATTTCTAGGAGTGCTTACTTGTATAGATCA
GCTACTTCGTAGCCCCGCCGAATCAGACGC|ACTATCCTCTTTGCATAAACGAGCCCTATC
AGTGCCTCTTTGTGTTTCAGACACTATTGT|ACCATGACCCGCTAGCAATCAGTAAAGCTT
TCTTTGCATAAACGAGCCCTGCCCTCTTAC|GTTTGGGAACTTTAACTATTTAACTATCCT
TCGAGCTCGTTCTAGTGCGTGCCACGGGCT|CTTTGCATAAACGAGCCCTTAACTTTAACT
TTCGTGCACCACGATGCCCCCCGTGACCAC|TAGCGAGTCCCGGCCTCTAAATGGCCTCAT
TGACCACATTACATACACTACGAAGCGGTG|GCCTCATAAGGACGCATGGACAAGCGGCAC
GTGTTTCCACCGATTATCTTATGTCGATGG|CTTTGCATAAACGAGCCCTAACGCGCGATC
CTTTGCATAAACGAGCCCTAGTCCCACGGC|CCACGATGCCCCCCGTGACCACATTACATA
GAAATGGAGTTGGGTTTCTGGCTCCATTCA|TGCAGCCGATCTAAGTTCACTAACCTTGAG
ACGAAGCTTAACTATCCTCTTTGCATAAAC|AGGCAATTATTTCGTGCACCACGATGCCCC
ACGATGCCCCCCGTGACCACATTACATACA|CGGCCTCTAAATGGCCTCATAAGGACGCAT
TCAGCCCGAGACGATTAACTATCCTCTTTG|GAGTTTACGCCGCGTCTCGCCTTCATAGCA
CATAAACGATTAACTATCCTCTTTGCATAA|ACGCTTCTCCCGCGGAATCGTTTGGGAACT
TGCCTGTGCGCCGCTATCCAACTTCGTATA|AAACGAGCCCTGCGACATTGCTTTACGGCG
TTTGCATAAACGAGCCCTATCCTCTTTGCA|GAGCCCTATACAAGTTTCCGCGTCAGATAG
CTACCCATTAATTTAACTATCCTCTTTGCA|GCCCTCTCTTTGCATAAACGATTAACTATC
CTGCCCTCTTACGTTAGTGTCGCATGGGAA|TTTAACTATCCTCTTTGCATAAACGAGCCC
AACGAGCCCTATACAAGTTTCCGCGTCAGA|ATCCAACTTCGTATATGTCGGAGACTCTCG
GCATAAACGAGCCCTATAGGAGTGTTTCCA|ACCCATTAATTTAACTATCCTCTTTGCATA
CCTCTTTGCATAAACGAGCCCTAGTCCCAC|GCACCACGATGCCCCCCGTGACCACATTAC
CGCGGAATCGTTTGGGAACTTTAACTATTT|ACGAGCCCTTGCACCCAAACTCGTACACAT
AAGCTTAACTATCCTCTTTGCATAAACGAG|CAATTATTTCGTGCACCACGATGCCCCCCG
TTGCATAAACGAGCCCTGCGACATTGCTTT|GCAGCAGACGGTGATGCAAACAATTGGCCT
ATTTAACTATCCTCTTTGCATAAACGAGCC|TGCATAAACGATTAACTATCCTCTTTGCAT
CTCATGAATTCGACAACCCAACCATAGCGG|CCATTCAGCCCGAGACGATTAACTATCCTC
CACGCTCCCACTGAAAGGGTCTTAACTATC|GACAACCCAACCATAGCGGAAGATCCTGCC
CTATCCTCTTTGCATAAACGAGCCCTAGCG|TGTTTCCACCGATTATCTTATGTCGATGGC
GCTCCATTCAGCCCGAGACGATTAACTATC|TAACCTTGAGTTTACGCCGCGTCTCGCCTT
AGTTTCCGCGTCAGATAGCAACTGACAATT|TGTCGGAGACTCTCGCTTTAAGTACTGTGC
ATCGGACATCTAACGATACTACCCATTAAT|TCCTCTTTGCATAAACGAGCCCTCTCTTTG
ACGGTTCTTAACTATCCTCTTTGCATAAAC|CCCTATAGGAGTGTTTCCACCGATTATCTT
CCTTAAAGTATCGCGCGCGCTAGCCAGGCA|CGGTTCTTAACTATCCTCTTTGCATAAACG
GCGACATTGCTTTACGGCGCCTTTAGTGCC|AAACAATTGGCCTGTCCTTAGTACACCATG
TAAACGAGCCCTATACAAGTTTCCGCGTCA|CTATCCAACTTCGTATATGTCGGAGACTCT
TGTCGCATGGGAATGGTTCGAGCTCGTTCT|CATAAACGAGCCCTCCTCTTTGCATAAACG
AAACGAGCCCTCCTCTTTGCATAAACGAGC|GAACCCCACGCTCCCACTGAAAGGGTCTTA
GCGGCGCGCTTAACTATCCTCTTTGCATAA|CTAGACGGTACAACTCGGCGGAGCGGAACT
CGAGACGATTAACTATCCTCTTTGCATAAA|ACGCCGCGTCTCGCCTTCATAGCAGCAGAC
CCATTAATGTTAACTATCCTCTTTGCATAA|ATCCATCGGACATCTAACGATACTACCCAT
CATAAACGAGCCCTTAACTTTAACTATCCT|AAAGGGTCTTAACTATCCTCTTTGCATAAA
CGAGCCCTATAGGAGTGTTTCCACCGATTA|AATTTAACTATCCTCTTTGCATAAACGAGC
TTGCATAAACGAGCCCTAACGCGCGATCTA|CTATCCTCTTTGCATAAACGAGCCCTGCCC
ATAATCCATCGGACATCTAACGATACTACC|TTAACTATCCTCTTTGCATAAACGAGCCCT
CGCTTTAAGTACTGTGCCGGCACGAGCGAA|TTTGTGTTTCAGACACTATTGTACGCGTGC
ATCCTCTTTGCATAAACGAGCCCTATCCTC|ATAAACGAGCCCTATACAAGTTTCCGCGTC
GCTTAACTATCCTCTTTGCATAAACGAGCC|ATTATTTCGTGCACCACGATGCCCCCCGTG
ATCAGACGCCCACGCTTCTCCCGCGGAATC|AGCCCTATCCTCTTTGCATAAACGAGCCCT
TAGCTTCTAGAACCCCACGCTCCCACTGAA|TCTCCTCATGAATTCGACAACCCAACCATA
CTGACAATTTCTAGGAGTGCTTACTTGTAT|GTACTGTGCCGGCACGAGCGAAATGGAGTT
ACTCGCTAATAGGGAAATTAACTATCTTAA|TGGTTCGAGCTCGTTCTAGTGCGTGCCACG
AAATGGCCTCATAAGGACGCATGGACAAGC|ATCCTCTTTGCATAAACGAGCCCTGTTTAG
TCTTAACTATCCTCTTTGCATAAACGAGCC|AAGATCCTGCCTGTGCGCCGCTATCCAACT
GGTCTTAACTATCCTCTTTGCATAAACGAG|GGAAGATCCTGCCTGTGCGCCGCTATCCAA
ACGAGCCCTGCCCTCTTACGTTAGTGTCGC|TTAACTATTTAACTATCCTCTTTGCATAAA
GCCCTCCCTTAAAGTATCGCGCGCGCTAGC|CGAGAACGGTTCTTAACTATCCTCTTTGCA
TGCATAAACGAGCCCTATACAAGTTTCCGC|GCCGCTATCCAACTTCGTATATGTCGGAGA
ATAGCAACTGACAATTTCTAGGAGTGCTTA|GCTTTAAGTACTGTGCCGGCACGAGCGAAA
ACCACATTACATACACTACGAAGCGGTGAG|CTCATAAGGACGCATGGACAAGCGGCACCA
ACTATCCTCTTTGCATAAACGAGCCCTCTC|GGGCTACTTCGTAGCCCCGCCGAATCAGAC
TTAACTATCCTCTTTGCATAAACGAGCCCT|GGAGTGTTTCCACCGATTATCTTATGTCGA
ATAGATCATTTCTCCTCATGAATTCGACAA|TTGGGTTTCTGGCTCCATTCAGCCCGAGAC
AGCGGAACTCGCTAATAGGGAAATTAACTA|TGGGAATGGTTCGAGCTCGTTCTAGTGCGT
TGTCGATGGCGGCGCGCTTAACTATCCTCT|CGCGCGATCTAGACGGTACAACTCGGCGGA
AACTATCCTCTTTGCATAAACGAGCCCTGC|TCGCCTTCATAGCAGCAGACGGTGATGCAA
ATCCTCTTTGCATAAACGAGCCCTATAGGA|AACGATACTACCCATTAATTTAACTATCCT
ATAAACGATTAACTATCCTCTTTGCATAAA|CGCTTCTCCCGCGGAATCGTTTGGGAACTT
CTATCCTCTTTGCATAAACGAGCCCTCCCT|AAGGGGGCTGAAGCTGCAGGACGAGAACGG
TCCCACGGCAGCAGGATAAAGCGGACTAGG|CATTACATACACTACGAAGCGGTGAGTGCA
GCGCTAGCCAGGCAATTATTTCGTGCACCA|TCTTTGCATAAACGAGCCCTAGCGAGTCCC
TTTGCATAAACGAGCCCTCCTCTTTGCATA|GCTTCTAGAACCCCACGCTCCCACTGAAAG
CCACGCTTCTCCCGCGGAATCGTTTGGGAA|CTCTTTGCATAAACGAGCCCTTGCACCCAA
CTTTGCATAAACGAGCCCTCCTCTTTGCAT|AGCTTCTAGAACCCCACGCTCCCACTGAAA
CGGCAGCAGGATAAAGCGGACTAGGCTCGA|CATACACTACGAAGCGGTGAGTGCAGACGC
TTGCATAAACGATTAACTATCCTCTTTGCA|CCCACGCTTCTCCCGCGGAATCGTTTGGGA
CTATACAAGTTTCCGCGTCAGATAGCAACT|TCGTATATGTCGGAGACTCTCGCTTTAAGT
ACTATCCTCTTTGCATAAACGAGCCCTGTT|ACTCGGCGGAGCGGAACTCGCTAATAGGGA
GAGACTCTCGCTTTAAGTACTGTGCCGGCA|AGTGCCTCTTTGTGTTTCAGACACTATTGT
GTATAGATCATTTCTCCTCATGAATTCGAC|AGTTGGGTTTCTGGCTCCATTCAGCCCGAG
TTTGCATAAACGAGCCCTGTTTAGTCCCTC|AGCGGAACTCGCTAATAGGGAAATTAACTA
TCCTACGAAAGCGACGAAGCTTAACTATCC|GCGCGCGCTAGCCAGGCAATTATTTCGTGC
GTATCGCGCGCGCTAGCCAGGCAATTATTT|TAACTATCCTCTTTGCATAAACGAGCCCTA
AGCTCGTTCTAGTGCGTGCCACGGGCTACT|TGCATAAACGAGCCCTTAACTTTAACTATC
CTATCCTCTTTGCATAAACGAGCCCTCTCT|GGCTACTTCGTAGCCCCGCCGAATCAGACG
CTAACGCGCGATCTAGACGGTACAACTCGG|AAACGAGCCCTGCCCTCTTACGTTAGTGTC
TTAGTCCCTCTGATAATCCATCGGACATCT|AAATTAACTATCTTAACTATCCTCTTTGCA
CATTACATACACTACGAAGCGGTGAGTGCA|TAAGGACGCATGGACAAGCGGCACCAGGAA
ACATCTAACGATACTACCCATTAATTTAAC|TTTGCATAAACGAGCCCTCTCTTTGCATAA
ACCCAAACTCGTACACATGCACGGCATAGC|AGGAGTGCTTACTTGTATAGATCATTTCTC
CCTCCCTTAAAGTATCGCGCGCGCTAGCCA|AGAACGGTTCTTAACTATCCTCTTTGCATA
TTCTAGTGCGTGCCACGGGCTACTTCGTAG|AACGAGCCCTTAACTTTAACTATCCTCTTT
TTACTTGTATAGATCATTTCTCCTCATGAA|AAATGGAGTTGGGTTTCTGGCTCCATTCAG
GCGAAATGGAGTTGGGTTTCTGGCTCCATT|CGTGCAGCCGATCTAAGTTCACTAACCTTG
TACTTGTATAGATCATTTCTCCTCATGAAT|AATGGAGTTGGGTTTCTGGCTCCATTCAGC
GCTCGATTAACTATCCTCTTTGCATAAACG|AGACGCTGATAAGGGGGCTGAAGCTGCAGG
ACCCATTAATTTAACTATCCTCTTTGCATA|CCTCTCTTTGCATAAACGATTAACTATCCT
GTGCAGACGCTGATAAGGGGGCTGAAGCTG|AGGAACCATTAATGTTAACTATCCTCTTTG
CCTCTAAATGGCCTCATAAGGACGCATGGA|TAACTATCCTCTTTGCATAAACGAGCCCTG
CCATTAATTTAACTATCCTCTTTGCATAAA|TCTCTTTGCATAAACGATTAACTATCCTCT
TCTTTGCATAAACGAGCCCTATACAAGTTT|GTGCGCCGCTATCCAACTTCGTATATGTCG
CATACACTACGAAGCGGTGAGTGCAGACGC|ACGCATGGACAAGCGGCACCAGGAACCATT
AAACGAGCCCTTAACTTTAACTATCCTCTT|GGGTCTTAACTATCCTCTTTGCATAAACGA
CCCTCTCTTTGCATAAACGATTAACTATCC|ATCAGACGCCCACGCTTCTCCCGCGGAATC
GTTCTTAACTATCCTCTTTGCATAAACGAG|TATAGGAGTGTTTCCACCGATTATCTTATG
CGATGCCCCCCGTGACCACATTACATACAC|GGCCTCTAAATGGCCTCATAAGGACGCATG
AGCCAGGCAATTATTTCGTGCACCACGATG|GCATAAACGAGCCCTAGCGAGTCCCGGCCT
TAATCCATCGGACATCTAACGATACTACCC|TAACTATCCTCTTTGCATAAACGAGCCCTC
TAACTATCCTCTTTGCATAAACGAGCCCTA|ATCCTGCCTGTGCGCCGCTATCCAACTTCG
CCTGTTTAGTCCCTCTGATAATCCATCGGA|TAGGGAAATTAACTATCTTAACTATCCTCT
CTGCAGGACGAGAACGGTTCTTAACTATCC|TTGCATAAACGAGCCCTATAGGAGTGTTTC
GAGTTGGGTTTCTGGCTCCATTCAGCCCGA|CGATCTAAGTTCACTAACCTTGAGTTTACG
CGAGCCCTGCCCTCTTACGTTAGTGTCGCA|TAACTATTTAACTATCCTCTTTGCATAAAC
CCCTTAACTTTAACTATCCTCTTTGCATAA|AACTATCCTCTTTGCATAAACGAGCCCTAT
AGGGAAATTAACTATCTTAACTATCCTCTT|TCGTTCTAGTGCGTGCCACGGGCTACTTCG
AACCATAGCGGAAGATCCTGCCTGTGCGCC|TAACTATCCTCTTTGCATAAACGAGCCCTG
GTTTCCACCGATTATCTTATGTCGATGGCG|TTGCATAAACGAGCCCTAACGCGCGATCTA
AAATGGAGTTGGGTTTCTGGCTCCATTCAG|GCAGCCGATCTAAGTTCACTAACCTTGAGT
CTTTGCATAAACGATTAACTATCCTCTTTG|CGCCCACGCTTCTCCCGCGGAATCGTTTGG
TAGGGAAATTAACTATCTTAACTATCCTCT|CTCGTTCTAGTGCGTGCCACGGGCTACTTC
GTACTGTGCCGGCACGAGCGAAATGGAGTT|TCAGACACTATTGTACGCGTGCAGCCGATC
TGCAGACGCTGATAAGGGGGCTGAAGCTGC|GGAACCATTAATGTTAACTATCCTCTTTGC
TATCCTCTTTGCATAAACGAGCCCTATAGG|TAACGATACTACCCATTAATTTAACTATCC
CAGCAGGATAAAGCGGACTAGGCTCGATTA|ACACTACGAAGCGGTGAGTGCAGACGCTGA
ACTTGTATAGATCATTTCTCCTCATGAATT|ATGGAGTTGGGTTTCTGGCTCCATTCAGCC
TTGCATAAACGAGCCCTGCCCTCTTACGTT|TGGGAACTTTAACTATTTAACTATCCTCTT
CGGTTCTTAACTATCCTCTTTGCATAAACG|CCTATAGGAGTGTTTCCACCGATTATCTTA
GGGAACTTTAACTATTTAACTATCCTCTTT|CCCAAACTCGTACACATGCACGGCATAGCT
ATCTTAACTATCCTCTTTGCATAAACGAGC|TGCCACGGGCTACTTCGTAGCCCCGCCGAA
CAGGACGAGAACGGTTCTTAACTATCCTCT|CATAAACGAGCCCTATAGGAGTGTTTCCAC
CTGATAATCCATCGGACATCTAACGATACT|ATCTTAACTATCCTCTTTGCATAAACGAGC
ACGTTAGTGTCGCATGGGAATGGTTCGAGC|CTCTTTGCATAAACGAGCCCTCCTCTTTGC
AGTCCCTCTGATAATCCATCGGACATCTAA|ATTAACTATCTTAACTATCCTCTTTGCATA
CCGAATCAGACGCCCACGCTTCTCCCGCGG|AACGAGCCCTATCCTCTTTGCATAAACGAG
ACAATTTCTAGGAGTGCTTACTTGTATAGA|CTGTGCCGGCACGAGCGAAATGGAGTTGGG
TCCTCATGAATTCGACAACCCAACCATAGC|CTCCATTCAGCCCGAGACGATTAACTATCC
CATTAATGTTAACTATCCTCTTTGCATAAA|TCCATCGGACATCTAACGATACTACCCATT
GAACTCGCTAATAGGGAAATTAACTATCTT|AATGGTTCGAGCTCGTTCTAGTGCGTGCCA
CTTTGCATAAACGAGCCCTGCGACATTGCT|TAGCAGCAGACGGTGATGCAAACAATTGGC
CGAGCCCTCTCTTTGCATAAACGATTAACT|CCGAATCAGACGCCCACGCTTCTCCCGCGG
TTCAGCCCGAGACGATTAACTATCCTCTTT|TGAGTTTACGCCGCGTCTCGCCTTCATAGC
CGCGCTTAACTATCCTCTTTGCATAAACGA|ACGGTACAACTCGGCGGAGCGGAACTCGCT
TGGCGGCGCGCTTAACTATCCTCTTTGCAT|ATCTAGACGGTACAACTCGGCGGAGCGGAA
CTAGACGGTACAACTCGGCGGAGCGGAACT|CCCTCTTACGTTAGTGTCGCATGGGAATGG
TTGCATAAACGAGCCCTATACAAGTTTCCG|CGCCGCTATCCAACTTCGTATATGTCGGAG
CAGGATAAAGCGGACTAGGCTCGATTAACT|CTACGAAGCGGTGAGTGCAGACGCTGATAA
TAACTATCCTCTTTGCATAAACGAGCCCTA|ATAAACGATTAACTATCCTCTTTGCATAAA
GACAAGCGGCACCAGGAACCATTAATGTTA|TGTTTAGTCCCTCTGATAATCCATCGGACA
TTGCATAAACGAGCCCTTGCACCCAAACTC|GATAGCAACTGACAATTTCTAGGAGTGCTT
TCAACAATCCTACGAAAGCGACGAAGCTTA|AAGTATCGCGCGCGCTAGCCAGGCAATTAT
CTATCCTCTTTGCATAAACGAGCCCTATAC|CTGCCTGTGCGCCGCTATCCAACTTCGTAT
ATTATCTTATGTCGATGGCGGCGCGCTTAA|GAGCCCTAACGCGCGATCTAGACGGTACAA
ACGAAAGCGACGAAGCTTAACTATCCTCTT|GCGCTAGCCAGGCAATTATTTCGTGCACCA
ATCCTCTTTGCATAAACGAGCCCTGCGACA|CTTCATAGCAGCAGACGGTGATGCAAACAA
CGCCGCTATCCAACTTCGTATATGTCGGAG|CCTGCGACATTGCTTTACGGCGCCTTTAGT
AATTTAACTATCCTCTTTGCATAAACGAGC|TTGCATAAACGATTAACTATCCTCTTTGCA
ACGAGCGAAATGGAGTTGGGTTTCTGGCTC|TACGCGTGCAGCCGATCTAAGTTCACTAAC
ACTAGGCTCGATTAACTATCCTCTTTGCAT|AGTGCAGACGCTGATAAGGGGGCTGAAGCT
TTAAAGTATCGCGCGCGCTAGCCAGGCAAT|GTTCTTAACTATCCTCTTTGCATAAACGAG
GAGCCCTCCCTTAAAGTATCGCGCGCGCTA|GACGAGAACGGTTCTTAACTATCCTCTTTG
GAGCCCTTGCACCCAAACTCGTACACATGC|GACAATTTCTAGGAGTGCTTACTTGTATAG
CCCTAACGCGCGATCTAGACGGTACAACTC|ATAAACGAGCCCTGCCCTCTTACGTTAGTG
ACGAGCCCTAGCGAGTCCCGGCCTCTAAAT|TTATGTCGATGGCGGCGCGCTTAACTATCC
TCTTTGCATAAACGAGCCCTTGCACCCAAA|TCAGATAGCAACTGACAATTTCTAGGAGTG
ATCCTCTTTGCATAAACGAGCCCTCCCTTA|GGGGGCTGAAGCTGCAGGACGAGAACGGTT
AATCGTTTGGGAACTTTAACTATTTAACTA|CCCTTGCACCCAAACTCGTACACATGCACG
CGTATATGTCGGAGACTCTCGCTTTAAGTA|ACGGCGCCTTTAGTGCCTCTTTGTGTTTCA
GTCGATGGCGGCGCGCTTAACTATCCTCTT|GCGCGATCTAGACGGTACAACTCGGCGGAG
AGGATAAAGCGGACTAGGCTCGATTAACTA|TACGAAGCGGTGAGTGCAGACGCTGATAAG
ACCAGGAACCATTAATGTTAACTATCCTCT|CTCTGATAATCCATCGGACATCTAACGATA
GCAGCAGGATAAAGCGGACTAGGCTCGATT|TACACTACGAAGCGGTGAGTGCAGACGCTG
TCCATCGGACATCTAACGATACTACCCATT|CTATCCTCTTTGCATAAACGAGCCCTCTCT
ATTACATACACTACGAAGCGGTGAGTGCAG|AAGGACGCATGGACAAGCGGCACCAGGAAC
CATAAACGAGCCCTGCGACATTGCTTTACG|GCAGACGGTGATGCAAACAATTGGCCTGTC
CACGAGCGAAATGGAGTTGGGTTTCTGGCT|GTACGCGTGCAGCCGATCTAAGTTCACTAA
TATCCTCTTTGCATAAACGAGCCCTTGCAC|CCGCGTCAGATAGCAACTGACAATTTCTAG
GTTTCCGCGTCAGATAGCAACTGACAATTT|GTCGGAGACTCTCGCTTTAAGTACTGTGCC
ACTTCGTATATGTCGGAGACTCTCGCTTTA|CTTTACGGCGCCTTTAGTGCCTCTTTGTGT
CTCTTTGCATAAACGAGCCCTAACGCGCGA|TTAACTATCCTCTTTGCATAAACGAGCCCT
GGGCTACTTCGTAGCCCCGCCGAATCAGAC|TAACTATCCTCTTTGCATAAACGAGCCCTA
GGTACAACTCGGCGGAGCGGAACTCGCTAA|TACGTTAGTGTCGCATGGGAATGGTTCGAG
CTCTTTGCATAAACGAGCCCTATACAAGTT|TGTGCGCCGCTATCCAACTTCGTATATGTC
GCATAAACGAGCCCTTGCACCCAAACTCGT|TAGCAACTGACAATTTCTAGGAGTGCTTAC
TACAAGTTTCCGCGTCAGATAGCAACTGAC|TATATGTCGGAGACTCTCGCTTTAAGTACT
CAACTGACAATTTCTAGGAGTGCTTACTTG|TAAGTACTGTGCCGGCACGAGCGAAATGGA
ATGTTAACTATCCTCTTTGCATAAACGAGC|CGGACATCTAACGATACTACCCATTAATTT
CTATCCAACTTCGTATATGTCGGAGACTCT|GACATTGCTTTACGGCGCCTTTAGTGCCTC
ACTATTTAACTATCCTCTTTGCATAAACGA|TACACATGCACGGCATAGCTTCTAGAACCC
ACGAGCCCTAACGCGCGATCTAGACGGTAC|TTTGCATAAACGAGCCCTGCCCTCTTACGT
CGCTTCTCCCGCGGAATCGTTTGGGAACTT|TTTGCATAAACGAGCCCTTGCACCCAAACT
TAGTGCCTCTTTGTGTTTCAGACACTATTG|CACCATGACCCGCTAGCAATCAGTAAAGCT
CCTCTTTGCATAAACGAGCCCTAGCGAGTC|TCCACCGATTATCTTATGTCGATGGCGGCG
ATCCTCTTTGCATAAACGAGCCCTGTTTAG|CGGCGGAGCGGAACTCGCTAATAGGGAAAT
CGATACTACCCATTAATTTAACTATCCTCT|AACGAGCCCTCTCTTTGCATAAACGATTAA
AACTATCCTCTTTGCATAAACGAGCCCTAA|TAAACGATTAACTATCCTCTTTGCATAAAC
ACGAGCCCTTAACTTTAACTATCCTCTTTG|GTCTTAACTATCCTCTTTGCATAAACGAGC
CTATCCTCTTTGCATAAACGAGCCCTGCCC|GGAATCGTTTGGGAACTTTAACTATTTAAC
GCATAAACGAGCCCTCTCTTTGCATAAACG|AGCCCCGCCGAATCAGACGCCCACGCTTCT
CAATTATTTCGTGCACCACGATGCCCCCCG|CGAGCCCTAGCGAGTCCCGGCCTCTAAATG
CGAAATGGAGTTGGGTTTCTGGCTCCATTC|GTGCAGCCGATCTAAGTTCACTAACCTTGA
TCTTTGCATAAACGAGCCCTAACGCGCGAT|TAACTATCCTCTTTGCATAAACGAGCCCTG
CAAGTTTCCGCGTCAGATAGCAACTGACAA|TATGTCGGAGACTCTCGCTTTAAGTACTGT
AATAGGGAAATTAACTATCTTAACTATCCT|AGCTCGTTCTAGTGCGTGCCACGGGCTACT
TCGTTTGGGAACTTTAACTATTTAACTATC|CTTGCACCCAAACTCGTACACATGCACGGC
GAGCGGAACTCGCTAATAGGGAAATTAACT|ATGGGAATGGTTCGAGCTCGTTCTAGTGCG
ACGATTAACTATCCTCTTTGCATAAACGAG|TCTCCCGCGGAATCGTTTGGGAACTTTAAC
TGCATAAACGAGCCCTATAGGAGTGTTTCC|TACCCATTAATTTAACTATCCTCTTTGCAT
TCGTACACATGCACGGCATAGCTTCTAGAA|TTACTTGTATAGATCATTTCTCCTCATGAA
CTTAACTATCCTCTTTGCATAAACGAGCCC|AGGAGTGTTTCCACCGATTATCTTATGTCG
TGCATAAACGAGCCCTCTCTTTGCATAAAC|TAGCCCCGCCGAATCAGACGCCCACGCTTC
AACGCGCGATCTAGACGGTACAACTCGGCG|ACGAGCCCTGCCCTCTTACGTTAGTGTCGC
AATCAGACGCCCACGCTTCTCCCGCGGAAT|GAGCCCTATCCTCTTTGCATAAACGAGCCC
TCAGATAGCAACTGACAATTTCTAGGAGTG|TCTCGCTTTAAGTACTGTGCCGGCACGAGC
TGGGAATGGTTCGAGCTCGTTCTAGTGCGT|GAGCCCTCCTCTTTGCATAAACGAGCCCTT
CGACGAAGCTTAACTATCCTCTTTGCATAA|CCAGGCAATTATTTCGTGCACCACGATGCC
TGCATAAACGAGCCCTCCTCTTTGCATAAA|TTCTAGAACCCCACGCTCCCACTGAAAGGG
GCATAAACGAGCCCTGCCCTCTTACGTTAG|GGAACTTTAACTATTTAACTATCCTCTTTG
CCCTATCCTCTTTGCATAAACGAGCCCTTG|TTTCCGCGTCAGATAGCAACTGACAATTTC
AGCCCTATCCTCTTTGCATAAACGAGCCCT|AGTTTCCGCGTCAGATAGCAACTGACAATT
CGTTTGGGAACTTTAACTATTTAACTATCC|TTGCACCCAAACTCGTACACATGCACGGCA
TATCCTCTTTGCATAAACGAGCCCTATCCT|CATAAACGAGCCCTATACAAGTTTCCGCGT
TCTAACGATACTACCCATTAATTTAACTAT|GCATAAACGAGCCCTCTCTTTGCATAAACG
CTATCCTCTTTGCATAAACGAGCCCTGTTT|CTCGGCGGAGCGGAACTCGCTAATAGGGAA
CCTATACAAGTTTCCGCGTCAGATAGCAAC|TTCGTATATGTCGGAGACTCTCGCTTTAAG
ACGAGCCCTATACAAGTTTCCGCGTCAGAT|TCCAACTTCGTATATGTCGGAGACTCTCGC
ACTACCCATTAATTTAACTATCCTCTTTGC|AGCCCTCTCTTTGCATAAACGATTAACTAT
CGGCATAGCTTCTAGAACCCCACGCTCCCA|TCATTTCTCCTCATGAATTCGACAACCCAA
ACCATAGCGGAAGATCCTGCCTGTGCGCCG|AACTATCCTCTTTGCATAAACGAGCCCTGC
AACTATCCTCTTTGCATAAACGAGCCCTCC|ATAAGGGGGCTGAAGCTGCAGGACGAGAAC
CAGGCAATTATTTCGTGCACCACGATGCCC|TAAACGAGCCCTAGCGAGTCCCGGCCTCTA
AAACTCGTACACATGCACGGCATAGCTTCT|GTGCTTACTTGTATAGATCATTTCTCCTCA
CTCGCTTTAAGTACTGTGCCGGCACGAGCG|TCTTTGTGTTTCAGACACTATTGTACGCGT
TCCTCTTTGCATAAACGAGCCCTAGTCCCA|TGCACCACGATGCCCCCCGTGACCACATTA
TGCATAAACGAGCCCTAACGCGCGATCTAG|TATCCTCTTTGCATAAACGAGCCCTGCCCT
CCTCTTTGCATAAACGAGCCCTCCTCTTTG|CATAGCTTCTAGAACCCCACGCTCCCACTG
AATGGCCTCATAAGGACGCATGGACAAGCG|TCCTCTTTGCATAAACGAGCCCTGTTTAGT
GGGGGCTGAAGCTGCAGGACGAGAACGGTT|AACTATCCTCTTTGCATAAACGAGCCCTAT
GGAACTTTAACTATTTAACTATCCTCTTTG|CCAAACTCGTACACATGCACGGCATAGCTT
GATGCCCCCCGTGACCACATTACATACACT|GCCTCTAAATGGCCTCATAAGGACGCATGG
TAAACGAGCCCTCCCTTAAAGTATCGCGCG|TGCAGGACGAGAACGGTTCTTAACTATCCT
ATCCTCTTTGCATAAACGAGCCCTTGCACC|CGCGTCAGATAGCAACTGACAATTTCTAGG
CATTTCTCCTCATGAATTCGACAACCCAAC|TTCTGGCTCCATTCAGCCCGAGACGATTAA
CGGCCTCTAAATGGCCTCATAAGGACGCAT|GCTTAACTATCCTCTTTGCATAAACGAGCC
CCCTGCGACATTGCTTTACGGCGCCTTTAG|ATGCAAACAATTGGCCTGTCCTTAGTACAC
TAAACGATTAACTATCCTCTTTGCATAAAC|GCTTCTCCCGCGGAATCGTTTGGGAACTTT
ACGAGCCCTCCTCTTTGCATAAACGAGCCC|ACCCCACGCTCCCACTGAAAGGGTCTTAAC
TACTGTGCCGGCACGAGCGAAATGGAGTTG|CAGACACTATTGTACGCGTGCAGCCGATCT
TCCATTCAGCCCGAGACGATTAACTATCCT|ACCTTGAGTTTACGCCGCGTCTCGCCTTCA
TATCGCGCGCGCTAGCCAGGCAATTATTTC|AACTATCCTCTTTGCATAAACGAGCCCTAG
TCTTTGCATAAACGAGCCCTATAGGAGTGT|ATACTACCCATTAATTTAACTATCCTCTTT
TAAAGCGGACTAGGCTCGATTAACTATCCT|AAGCGGTGAGTGCAGACGCTGATAAGGGGG
CACATTACATACACTACGAAGCGGTGAGTG|CATAAGGACGCATGGACAAGCGGCACCAGG
AAGTACTGTGCCGGCACGAGCGAAATGGAG|TTTCAGACACTATTGTACGCGTGCAGCCGA
CATGGGAATGGTTCGAGCTCGTTCTAGTGC|ACGAGCCCTCCTCTTTGCATAAACGAGCCC
ATGGAGTTGGGTTTCTGGCTCCATTCAGCC|AGCCGATCTAAGTTCACTAACCTTGAGTTT
CGTAGCCCCGCCGAATCAGACGCCCACGCT|TCTTTGCATAAACGAGCCCTATCCTCTTTG
GTCGCATGGGAATGGTTCGAGCTCGTTCTA|ATAAACGAGCCCTCCTCTTTGCATAAACGA
AGTGTCGCATGGGAATGGTTCGAGCTCGTT|TGCATAAACGAGCCCTCCTCTTTGCATAAA
TAACTATCTTAACTATCCTCTTTGCATAAA|GTGCGTGCCACGGGCTACTTCGTAGCCCCG
GCGAGTCCCGGCCTCTAAATGGCCTCATAA|GGCGGCGCGCTTAACTATCCTCTTTGCATA
ACTCGGCGGAGCGGAACTCGCTAATAGGGA|AGTGTCGCATGGGAATGGTTCGAGCTCGTT
ATCTAGACGGTACAACTCGGCGGAGCGGAA|TGCCCTCTTACGTTAGTGTCGCATGGGAAT
TTCCACCGATTATCTTATGTCGATGGCGGC|GCATAAACGAGCCCTAACGCGCGATCTAGA
AAACGAGCCCTGCCCTCTTACGTTAGTGTC|CTTTAACTATTTAACTATCCTCTTTGCATA
CGAAGCTTAACTATCCTCTTTGCATAAACG|GGCAATTATTTCGTGCACCACGATGCCCCC
TTTCCACCGATTATCTTATGTCGATGGCGG|TGCATAAACGAGCCCTAACGCGCGATCTAG
ATAAACGAGCCCTGCCCTCTTACGTTAGTG|AACTTTAACTATTTAACTATCCTCTTTGCA
ATGAATTCGACAACCCAACCATAGCGGAAG|TTCAGCCCGAGACGATTAACTATCCTCTTT
CTCTGATAATCCATCGGACATCTAACGATA|CTATCTTAACTATCCTCTTTGCATAAACGA
CTAGTGCGTGCCACGGGCTACTTCGTAGCC|CGAGCCCTTAACTTTAACTATCCTCTTTGC
GTTAACTATCCTCTTTGCATAAACGAGCCC|GACATCTAACGATACTACCCATTAATTTAA
TATCTTATGTCGATGGCGGCGCGCTTAACT|GCCCTAACGCGCGATCTAGACGGTACAACT
TTTCTAGGAGTGCTTACTTGTATAGATCAT|GCCGGCACGAGCGAAATGGAGTTGGGTTTC
TTTGCATAAACGAGCCCTAGTCCCACGGCA|CACGATGCCCCCCGTGACCACATTACATAC
ACAAGCGGCACCAGGAACCATTAATGTTAA|GTTTAGTCCCTCTGATAATCCATCGGACAT
TCTTATGTCGATGGCGGCGCGCTTAACTAT|CCTAACGCGCGATCTAGACGGTACAACTCG
TTAGTGCCTCTTTGTGTTTCAGACACTATT|ACACCATGACCCGCTAGCAATCAGTAAAGC
AACTATCCTCTTTGCATAAACGAGCCCTAT|TCCTGCCTGTGCGCCGCTATCCAACTTCGT
TAACTATCCTCTTTGCATAAACGAGCCCTC|GATAAGGGGGCTGAAGCTGCAGGACGAGAA
AGCCCTAGTCCCACGGCAGCAGGATAAAGC|CGTGACCACATTACATACACTACGAAGCGG
CCCTTGCACCCAAACTCGTACACATGCACG|AATTTCTAGGAGTGCTTACTTGTATAGATC
GTGAGTGCAGACGCTGATAAGGGGGCTGAA|CACCAGGAACCATTAATGTTAACTATCCTC
TGAATTCGACAACCCAACCATAGCGGAAGA|TCAGCCCGAGACGATTAACTATCCTCTTTG
CGGAACTCGCTAATAGGGAAATTAACTATC|GGAATGGTTCGAGCTCGTTCTAGTGCGTGC
GTGTCGCATGGGAATGGTTCGAGCTCGTTC|GCATAAACGAGCCCTCCTCTTTGCATAAAC
GGAGTGTTTCCACCGATTATCTTATGTCGA|CCTCTTTGCATAAACGAGCCCTAACGCGCG
ACGAGCCCTAGTCCCACGGCAGCAGGATAA|CCCCGTGACCACATTACATACACTACGAAG
ACAAGTTTCCGCGTCAGATAGCAACTGACA|ATATGTCGGAGACTCTCGCTTTAAGTACTG
GGAGCGGAACTCGCTAATAGGGAAATTAAC|CATGGGAATGGTTCGAGCTCGTTCTAGTGC
CCGAGACGATTAACTATCCTCTTTGCATAA|TACGCCGCGTCTCGCCTTCATAGCAGCAGA
GCACGAGCGAAATGGAGTTGGGTTTCTGGC|TGTACGCGTGCAGCCGATCTAAGTTCACTA
CCTAACGCGCGATCTAGACGGTACAACTCG|TAAACGAGCCCTGCCCTCTTACGTTAGTGT
ATAAACGAGCCCTCCCTTAAAGTATCGCGC|CTGCAGGACGAGAACGGTTCTTAACTATCC
CTAAATGGCCTCATAAGGACGCATGGACAA|CTATCCTCTTTGCATAAACGAGCCCTGTTT
CTGAAGCTGCAGGACGAGAACGGTTCTTAA|TCCTCTTTGCATAAACGAGCCCTATAGGAG
GAAAGCGACGAAGCTTAACTATCCTCTTTG|GCTAGCCAGGCAATTATTTCGTGCACCACG
GCCCTCCTCTTTGCATAAACGAGCCCTTAA|CACGCTCCCACTGAAAGGGTCTTAACTATC
CTCCTCATGAATTCGACAACCCAACCATAG|GCTCCATTCAGCCCGAGACGATTAACTATC
GGCAATTATTTCGTGCACCACGATGCCCCC|AACGAGCCCTAGCGAGTCCCGGCCTCTAAA
ATCCTGCCTGTGCGCCGCTATCCAACTTCG|GCATAAACGAGCCCTGCGACATTGCTTTAC
ATAGGAGTGTTTCCACCGATTATCTTATGT|TATCCTCTTTGCATAAACGAGCCCTAACGC
TCTTTGCATAAACGAGCCCTCTCTTTGCAT|TTCGTAGCCCCGCCGAATCAGACGCCCACG
CACCCAAACTCGTACACATGCACGGCATAG|TAGGAGTGCTTACTTGTATAGATCATTTCT
TAGTCCCTCTGATAATCCATCGGACATCTA|AATTAACTATCTTAACTATCCTCTTTGCAT
ACACATGCACGGCATAGCTTCTAGAACCCC|TTGTATAGATCATTTCTCCTCATGAATTCG
CGCTAGCCAGGCAATTATTTCGTGCACCAC|CTTTGCATAAACGAGCCCTAGCGAGTCCCG
GGGAAATTAACTATCTTAACTATCCTCTTT|CGTTCTAGTGCGTGCCACGGGCTACTTCGT
CCTATCCTCTTTGCATAAACGAGCCCTTGC|TTCCGCGTCAGATAGCAACTGACAATTTCT
AACTATCCTCTTTGCATAAACGAGCCCTAT|ATCTAACGATACTACCCATTAATTTAACTA
CGAGCCCTATACAAGTTTCCGCGTCAGATA|CCAACTTCGTATATGTCGGAGACTCTCGCT
GAACTTTAACTATTTAACTATCCTCTTTGC|CAAACTCGTACACATGCACGGCATAGCTTC
CCCAACCATAGCGGAAGATCCTGCCTGTGC|GATTAACTATCCTCTTTGCATAAACGAGCC
TATCCTCTTTGCATAAACGAGCCCTAGTCC|CGTGCACCACGATGCCCCCCGTGACCACAT
ACTCGTACACATGCACGGCATAGCTTCTAG|GCTTACTTGTATAGATCATTTCTCCTCATG
CCCTATACAAGTTTCCGCGTCAGATAGCAA|CTTCGTATATGTCGGAGACTCTCGCTTTAA
CGCTATCCAACTTCGTATATGTCGGAGACT|GCGACATTGCTTTACGGCGCCTTTAGTGCC
TAAACGAGCCCTAACGCGCGATCTAGACGG|CTCTTTGCATAAACGAGCCCTGCCCTCTTA
CATAAACGAGCCCTATAGGAGTGTTTCCAC|CCCATTAATTTAACTATCCTCTTTGCATAA
ACATTACATACACTACGAAGCGGTGAGTGC|ATAAGGACGCATGGACAAGCGGCACCAGGA
CCAGGCAATTATTTCGTGCACCACGATGCC|ATAAACGAGCCCTAGCGAGTCCCGGCCTCT
GACTCTCGCTTTAAGTACTGTGCCGGCACG|TGCCTCTTTGTGTTTCAGACACTATTGTAC
GCATAAACGAGCCCTGTTTAGTCCCTCTGA|GGAACTCGCTAATAGGGAAATTAACTATCT
AGACTCTCGCTTTAAGTACTGTGCCGGCAC|GTGCCTCTTTGTGTTTCAGACACTATTGTA
TTTGCATAAACGAGCCCTCTCTTTGCATAA|CGTAGCCCCGCCGAATCAGACGCCCACGCT
GCATAGCTTCTAGAACCCCACGCTCCCACT|ATTTCTCCTCATGAATTCGACAACCCAACC
CGATTATCTTATGTCGATGGCGGCGCGCTT|ACGAGCCCTAACGCGCGATCTAGACGGTAC
CGAATCAGACGCCCACGCTTCTCCCGCGGA|ACGAGCCCTATCCTCTTTGCATAAACGAGC
CACCACGATGCCCCCCGTGACCACATTACA|GTCCCGGCCTCTAAATGGCCTCATAAGGAC
AATGGTTCGAGCTCGTTCTAGTGCGTGCCA|CCTCCTCTTTGCATAAACGAGCCCTTAACT
TGCATAAACGAGCCCTAGTCCCACGGCAGC|CGATGCCCCCCGTGACCACATTACATACAC
ACTTTAACTATTTAACTATCCTCTTTGCAT|AACTCGTACACATGCACGGCATAGCTTCTA
TATCCTCTTTGCATAAACGAGCCCTCTCTT|GCTACTTCGTAGCCCCGCCGAATCAGACGC
TGGGTTTCTGGCTCCATTCAGCCCGAGACG|CTAAGTTCACTAACCTTGAGTTTACGCCGC
AAGTTTCCGCGTCAGATAGCAACTGACAAT|ATGTCGGAGACTCTCGCTTTAAGTACTGTG
TCCGCGTCAGATAGCAACTGACAATTTCTA|GGAGACTCTCGCTTTAAGTACTGTGCCGGC
CTCTCTTTGCATAAACGATTAACTATCCTC|CAGACGCCCACGCTTCTCCCGCGGAATCGT
TTAACTATCCTCTTTGCATAAACGAGCCCT|CATAAACGATTAACTATCCTCTTTGCATAA
GAGCTCGTTCTAGTGCGTGCCACGGGCTAC|TTGCATAAACGAGCCCTTAACTTTAACTAT
GTCCCACGGCAGCAGGATAAAGCGGACTAG|ACATTACATACACTACGAAGCGGTGAGTGC
TCGACAACCCAACCATAGCGGAAGATCCTG|CCGAGACGATTAACTATCCTCTTTGCATAA
TGAAAGGGTCTTAACTATCCTCTTTGCATA|CATAGCGGAAGATCCTGCCTGTGCGCCGCT
CGGGCTACTTCGTAGCCCCGCCGAATCAGA|TTAACTATCCTCTTTGCATAAACGAGCCCT
CCTCCTCTTTGCATAAACGAGCCCTTAACT|CGCTCCCACTGAAAGGGTCTTAACTATCCT
TTTCCGCGTCAGATAGCAACTGACAATTTC|TCGGAGACTCTCGCTTTAAGTACTGTGCCG
TTCTAGGAGTGCTTACTTGTATAGATCATT|CCGGCACGAGCGAAATGGAGTTGGGTTTCT
CCATAGCGGAAGATCCTGCCTGTGCGCCGC|ACTATCCTCTTTGCATAAACGAGCCCTGCG
AAACGAGCCCTATAGGAGTGTTTCCACCGA|ATTAATTTAACTATCCTCTTTGCATAAACG
ACTGAAAGGGTCTTAACTATCCTCTTTGCA|ACCATAGCGGAAGATCCTGCCTGTGCGCCG
TCCTCTTTGCATAAACGAGCCCTTGCACCC|GCGTCAGATAGCAACTGACAATTTCTAGGA
TCTTTGCATAAACGAGCCCTGCGACATTGC|ATAGCAGCAGACGGTGATGCAAACAATTGG
ATTATTTCGTGCACCACGATGCCCCCCGTG|AGCCCTAGCGAGTCCCGGCCTCTAAATGGC
ATTAACTATCCTCTTTGCATAAACGAGCCC|CCCGCGGAATCGTTTGGGAACTTTAACTAT
CATAAACGAGCCCTATACAAGTTTCCGCGT|CGCTATCCAACTTCGTATATGTCGGAGACT
AGACGCCCACGCTTCTCCCGCGGAATCGTT|CCTATCCTCTTTGCATAAACGAGCCCTTGC
ATCCTCTTTGCATAAACGAGCCCTATACAA|GCCTGTGCGCCGCTATCCAACTTCGTATAT
AACGAGCCCTAGTCCCACGGCAGCAGGATA|CCCCCGTGACCACATTACATACACTACGAA
CGGTGAGTGCAGACGCTGATAAGGGGGCTG|GGCACCAGGAACCATTAATGTTAACTATCC
CGGACATCTAACGATACTACCCATTAATTT|CTCTTTGCATAAACGAGCCCTCTCTTTGCA
TCCCGGCCTCTAAATGGCCTCATAAGGACG|CGCGCTTAACTATCCTCTTTGCATAAACGA
TCCTCTTTGCATAAACGAGCCCTGCCCTCT|ATCGTTTGGGAACTTTAACTATTTAACTAT
TCTAAATGGCCTCATAAGGACGCATGGACA|ACTATCCTCTTTGCATAAACGAGCCCTGTT
CAATCCTACGAAAGCGACGAAGCTTAACTA|ATCGCGCGCGCTAGCCAGGCAATTATTTCG
GAGCCCTCCTCTTTGCATAAACGAGCCCTT|CCCACGCTCCCACTGAAAGGGTCTTAACTA
CCCGAGACGATTAACTATCCTCTTTGCATA|TTACGCCGCGTCTCGCCTTCATAGCAGCAG
ATTTCGTGCACCACGATGCCCCCCGTGACC|CCTAGCGAGTCCCGGCCTCTAAATGGCCTC
AGCGGCACCAGGAACCATTAATGTTAACTA|TAGTCCCTCTGATAATCCATCGGACATCTA
AACTCGGCGGAGCGGAACTCGCTAATAGGG|TAGTGTCGCATGGGAATGGTTCGAGCTCGT
CTCTTTGCATAAACGAGCCCTATCCTCTTT|AACGAGCCCTATACAAGTTTCCGCGTCAGA
TAAACGAGCCCTTAACTTTAACTATCCTCT|AGGGTCTTAACTATCCTCTTTGCATAAACG
CTTTGCATAAACGAGCCCTATAGGAGTGTT|TACTACCCATTAATTTAACTATCCTCTTTG
GCGCCTTTAGTGCCTCTTTGTGTTTCAGAC|CTTAGTACACCATGACCCGCTAGCAATCAG
AACGAGCCCTCTCTTTGCATAAACGATTAA|CGCCGAATCAGACGCCCACGCTTCTCCCGC
CTCTAAATGGCCTCATAAGGACGCATGGAC|AACTATCCTCTTTGCATAAACGAGCCCTGT
TAATAGGGAAATTAACTATCTTAACTATCC|GAGCTCGTTCTAGTGCGTGCCACGGGCTAC
TTAAGTACTGTGCCGGCACGAGCGAAATGG|TGTTTCAGACACTATTGTACGCGTGCAGCC
TTTACGGCGCCTTTAGTGCCTCTTTGTGTT|CCTGTCCTTAGTACACCATGACCCGCTAGC
ATAAACGAGCCCTAACGCGCGATCTAGACG|CCTCTTTGCATAAACGAGCCCTGCCCTCTT
GATTAACTATCCTCTTTGCATAAACGAGCC|GCTGATAAGGGGGCTGAAGCTGCAGGACGA
AGAACCCCACGCTCCCACTGAAAGGGTCTT|TGAATTCGACAACCCAACCATAGCGGAAGA
GGGAATGGTTCGAGCTCGTTCTAGTGCGTG|AGCCCTCCTCTTTGCATAAACGAGCCCTTA
GACATTGCTTTACGGCGCCTTTAGTGCCTC|ACAATTGGCCTGTCCTTAGTACACCATGAC
TCTAGTGCGTGCCACGGGCTACTTCGTAGC|ACGAGCCCTTAACTTTAACTATCCTCTTTG
TATCCTCTTTGCATAAACGAGCCCTCCCTT|AGGGGGCTGAAGCTGCAGGACGAGAACGGT
TAACTATCCTCTTTGCATAAACGAGCCCTA|CATCTAACGATACTACCCATTAATTTAACT
CGAGCCCTCCCTTAAAGTATCGCGCGCGCT|GGACGAGAACGGTTCTTAACTATCCTCTTT
TATGTCGATGGCGGCGCGCTTAACTATCCT|AACGCGCGATCTAGACGGTACAACTCGGCG
TGCATAAACGAGCCCTGCGACATTGCTTTA|CAGCAGACGGTGATGCAAACAATTGGCCTG
GGACGCATGGACAAGCGGCACCAGGAACCA|AACGAGCCCTGTTTAGTCCCTCTGATAATC
CCAAACTCGTACACATGCACGGCATAGCTT|GAGTGCTTACTTGTATAGATCATTTCTCCT
GCATAAACGAGCCCTCCTCTTTGCATAAAC|TCTAGAACCCCACGCTCCCACTGAAAGGGT
ATAAACGAGCCCTATCCTCTTTGCATAAAC|CTATACAAGTTTCCGCGTCAGATAGCAACT
AAACGAGCCCTGCGACATTGCTTTACGGCG|GACGGTGATGCAAACAATTGGCCTGTCCTT
CAACCATAGCGGAAGATCCTGCCTGTGCGC|TTAACTATCCTCTTTGCATAAACGAGCCCT
CAACAATCCTACGAAAGCGACGAAGCTTAA|AGTATCGCGCGCGCTAGCCAGGCAATTATT
GTCTTAACTATCCTCTTTGCATAAACGAGC|GAAGATCCTGCCTGTGCGCCGCTATCCAAC
AATTTCTAGGAGTGCTTACTTGTATAGATC|GTGCCGGCACGAGCGAAATGGAGTTGGGTT
GAAGCGGTGAGTGCAGACGCTGATAAGGGG|AAGCGGCACCAGGAACCATTAATGTTAACT
ACGCTGATAAGGGGGCTGAAGCTGCAGGAC|CATTAATGTTAACTATCCTCTTTGCATAAA
CCGGCACGAGCGAAATGGAGTTGGGTTTCT|TATTGTACGCGTGCAGCCGATCTAAGTTCA
AACTATCCTCTTTGCATAAACGAGCCCTAG|TTTCGTGCACCACGATGCCCCCCGTGACCA
GACGATTAACTATCCTCTTTGCATAAACGA|CCGCGTCTCGCCTTCATAGCAGCAGACGGT
AGCTTAACTATCCTCTTTGCATAAACGAGC|AATTATTTCGTGCACCACGATGCCCCCCGT
CCTCTCTTTGCATAAACGATTAACTATCCT|TCAGACGCCCACGCTTCTCCCGCGGAATCG
TGCATAAACGAGCCCTCCCTTAAAGTATCG|AAGCTGCAGGACGAGAACGGTTCTTAACTA
GTCCCTCTGATAATCCATCGGACATCTAAC|TTAACTATCTTAACTATCCTCTTTGCATAA
AAAGGGTCTTAACTATCCTCTTTGCATAAA|TAGCGGAAGATCCTGCCTGTGCGCCGCTAT
GCGCGCTAGCCAGGCAATTATTTCGTGCAC|CCTCTTTGCATAAACGAGCCCTAGCGAGTC
CTATCCTCTTTGCATAAACGAGCCCTCCTC|ACGGCATAGCTTCTAGAACCCCACGCTCCC
TACGTTAGTGTCGCATGGGAATGGTTCGAG|CCTCTTTGCATAAACGAGCCCTCCTCTTTG
CTTCGTAGCCCCGCCGAATCAGACGCCCAC|TCCTCTTTGCATAAACGAGCCCTATCCTCT
AGCCCTTGCACCCAAACTCGTACACATGCA|ACAATTTCTAGGAGTGCTTACTTGTATAGA
AACTATTTAACTATCCTCTTTGCATAAACG|GTACACATGCACGGCATAGCTTCTAGAACC
ACGAGCCCTGCGACATTGCTTTACGGCGCC|CGGTGATGCAAACAATTGGCCTGTCCTTAG
TTTGCATAAACGAGCCCTGCGACATTGCTT|AGCAGCAGACGGTGATGCAAACAATTGGCC
TGATAAGGGGGCTGAAGCTGCAGGACGAGA|AATGTTAACTATCCTCTTTGCATAAACGAG
TTAACTATCCTCTTTGCATAAACGAGCCCT|TATTTCGTGCACCACGATGCCCCCCGTGAC
CATCTAACGATACTACCCATTAATTTAACT|TTGCATAAACGAGCCCTCTCTTTGCATAAA
GCCCTCTTACGTTAGTGTCGCATGGGAATG|TAACTATCCTCTTTGCATAAACGAGCCCTC
CTTAACTATCCTCTTTGCATAAACGAGCCC|AGATCCTGCCTGTGCGCCGCTATCCAACTT
ATAAGGGGGCTGAAGCTGCAGGACGAGAAC|TGTTAACTATCCTCTTTGCATAAACGAGCC
GGCGGCGCGCTTAACTATCCTCTTTGCATA|TCTAGACGGTACAACTCGGCGGAGCGGAAC
ACGAGCCCTATCCTCTTTGCATAAACGAGC|ACAAGTTTCCGCGTCAGATAGCAACTGACA
TATAGATCATTTCTCCTCATGAATTCGACA|GTTGGGTTTCTGGCTCCATTCAGCCCGAGA
ATAAACGAGCCCTTGCACCCAAACTCGTAC|GCAACTGACAATTTCTAGGAGTGCTTACTT
TAGCGGAAGATCCTGCCTGTGCGCCGCTAT|ATCCTCTTTGCATAAACGAGCCCTGCGACA
GGCCTCATAAGGACGCATGGACAAGCGGCA|TCTTTGCATAAACGAGCCCTGTTTAGTCCC
GCTGATAAGGGGGCTGAAGCTGCAGGACGA|TTAATGTTAACTATCCTCTTTGCATAAACG
GTATATGTCGGAGACTCTCGCTTTAAGTAC|CGGCGCCTTTAGTGCCTCTTTGTGTTTCAG
ACACTACGAAGCGGTGAGTGCAGACGCTGA|CATGGACAAGCGGCACCAGGAACCATTAAT
AGCCCTCCTCTTTGCATAAACGAGCCCTTA|CCACGCTCCCACTGAAAGGGTCTTAACTAT
ACATTGCTTTACGGCGCCTTTAGTGCCTCT|CAATTGGCCTGTCCTTAGTACACCATGACC
CTATTTAACTATCCTCTTTGCATAAACGAG|ACACATGCACGGCATAGCTTCTAGAACCCC
CCTACGAAAGCGACGAAGCTTAACTATCCT|CGCGCGCTAGCCAGGCAATTATTTCGTGCA
AGCCCTATACAAGTTTCCGCGTCAGATAGC|AACTTCGTATATGTCGGAGACTCTCGCTTT
AGGAGTGTTTCCACCGATTATCTTATGTCG|TCCTCTTTGCATAAACGAGCCCTAACGCGC
CGCGATCTAGACGGTACAACTCGGCGGAGC|GCCCTGCCCTCTTACGTTAGTGTCGCATGG
CACTGAAAGGGTCTTAACTATCCTCTTTGC|AACCATAGCGGAAGATCCTGCCTGTGCGCC
CCCCGCCGAATCAGACGCCCACGCTTCTCC|GCATAAACGAGCCCTATCCTCTTTGCATAA
CTTAACTATCCTCTTTGCATAAACGAGCCC|TACAACTCGGCGGAGCGGAACTCGCTAATA
ACGAAGCGGTGAGTGCAGACGCTGATAAGG|ACAAGCGGCACCAGGAACCATTAATGTTAA
CATAAACGAGCCCTTGCACCCAAACTCGTA|AGCAACTGACAATTTCTAGGAGTGCTTACT
GCCCTGTTTAGTCCCTCTGATAATCCATCG|AATAGGGAAATTAACTATCTTAACTATCCT
TCCTCTTTGCATAAACGAGCCCTTAACTTT|CTCCCACTGAAAGGGTCTTAACTATCCTCT
CATAGCGGAAGATCCTGCCTGTGCGCCGCT|CTATCCTCTTTGCATAAACGAGCCCTGCGA
CCTTTAGTGCCTCTTTGTGTTTCAGACACT|AGTACACCATGACCCGCTAGCAATCAGTAA
TAACTATCCTCTTTGCATAAACGAGCCCTG|CTCGCCTTCATAGCAGCAGACGGTGATGCA
GGCTCGATTAACTATCCTCTTTGCATAAAC|CAGACGCTGATAAGGGGGCTGAAGCTGCAG
GATCATTTCTCCTCATGAATTCGACAACCC|GGTTTCTGGCTCCATTCAGCCCGAGACGAT
CCCCACGCTCCCACTGAAAGGGTCTTAACT|TTCGACAACCCAACCATAGCGGAAGATCCT
GTGCCACGGGCTACTTCGTAGCCCCGCCGA|TTAACTTTAACTATCCTCTTTGCATAAACG
ATAAACGAGCCCTGCGACATTGCTTTACGG|CAGACGGTGATGCAAACAATTGGCCTGTCC
CGCTAATAGGGAAATTAACTATCTTAACTA|TTCGAGCTCGTTCTAGTGCGTGCCACGGGC
AAGCGACGAAGCTTAACTATCCTCTTTGCA|TAGCCAGGCAATTATTTCGTGCACCACGAT
TCCTCTTTGCATAAACGAGCCCTGTTTAGT|GGCGGAGCGGAACTCGCTAATAGGGAAATT
CTTGTATAGATCATTTCTCCTCATGAATTC|TGGAGTTGGGTTTCTGGCTCCATTCAGCCC
GGCACGAGCGAAATGGAGTTGGGTTTCTGG|TTGTACGCGTGCAGCCGATCTAAGTTCACT
GATAAGGGGGCTGAAGCTGCAGGACGAGAA|ATGTTAACTATCCTCTTTGCATAAACGAGC
TGCCCTCTTACGTTAGTGTCGCATGGGAAT|TTAACTATCCTCTTTGCATAAACGAGCCCT
AGGCAATTATTTCGTGCACCACGATGCCCC|AAACGAGCCCTAGCGAGTCCCGGCCTCTAA
GATTATCTTATGTCGATGGCGGCGCGCTTA|CGAGCCCTAACGCGCGATCTAGACGGTACA
AGTACTGTGCCGGCACGAGCGAAATGGAGT|TTCAGACACTATTGTACGCGTGCAGCCGAT
GACGCCCACGCTTCTCCCGCGGAATCGTTT|CTATCCTCTTTGCATAAACGAGCCCTTGCA
ACGGCGCCTTTAGTGCCTCTTTGTGTTTCA|GTCCTTAGTACACCATGACCCGCTAGCAAT
CGAGCCCTTAACTTTAACTATCCTCTTTGC|TCTTAACTATCCTCTTTGCATAAACGAGCC
TATATGTCGGAGACTCTCGCTTTAAGTACT|GGCGCCTTTAGTGCCTCTTTGTGTTTCAGA
AGGACGAGAACGGTTCTTAACTATCCTCTT|ATAAACGAGCCCTATAGGAGTGTTTCCACC
GCCGCTATCCAACTTCGTATATGTCGGAGA|CTGCGACATTGCTTTACGGCGCCTTTAGTG
CTATCCTCTTTGCATAAACGAGCCCTTGCA|TCCGCGTCAGATAGCAACTGACAATTTCTA
TAGAACCCCACGCTCCCACTGAAAGGGTCT|ATGAATTCGACAACCCAACCATAGCGGAAG
CGCTCCCACTGAAAGGGTCTTAACTATCCT|CAACCCAACCATAGCGGAAGATCCTGCCTG
CGAAGCGGTGAGTGCAGACGCTGATAAGGG|CAAGCGGCACCAGGAACCATTAATGTTAAC
GCCCTAGCGAGTCCCGGCCTCTAAATGGCC|GTCGATGGCGGCGCGCTTAACTATCCTCTT
ATAAACGAGCCCTCCTCTTTGCATAAACGA|TAGAACCCCACGCTCCCACTGAAAGGGTCT
AATGGAGTTGGGTTTCTGGCTCCATTCAGC|CAGCCGATCTAAGTTCACTAACCTTGAGTT
CTACGAAAGCGACGAAGCTTAACTATCCTC|GCGCGCTAGCCAGGCAATTATTTCGTGCAC
GCTAGCCAGGCAATTATTTCGTGCACCACG|TTTGCATAAACGAGCCCTAGCGAGTCCCGG
GCCGGCACGAGCGAAATGGAGTTGGGTTTC|CTATTGTACGCGTGCAGCCGATCTAAGTTC
CTCTTTGCATAAACGAGCCCTGCCCTCTTA|CGTTTGGGAACTTTAACTATTTAACTATCC
CGCCCACGCTTCTCCCGCGGAATCGTTTGG|ATCCTCTTTGCATAAACGAGCCCTTGCACC
TATAGGAGTGTTTCCACCGATTATCTTATG|CTATCCTCTTTGCATAAACGAGCCCTAACG
GCCACGGGCTACTTCGTAGCCCCGCCGAAT|AACTTTAACTATCCTCTTTGCATAAACGAG
TCTCTTTGCATAAACGATTAACTATCCTCT|AGACGCCCACGCTTCTCCCGCGGAATCGTT
ACCATTAATGTTAACTATCCTCTTTGCATA|AATCCATCGGACATCTAACGATACTACCCA
CTCCCTTAAAGTATCGCGCGCGCTAGCCAG|GAACGGTTCTTAACTATCCTCTTTGCATAA
GCTAATAGGGAAATTAACTATCTTAACTAT|TCGAGCTCGTTCTAGTGCGTGCCACGGGCT
CCTCTTTGCATAAACGAGCCCTATCCTCTT|AAACGAGCCCTATACAAGTTTCCGCGTCAG
TAACTATCCTCTTTGCATAAACGAGCCCTA|ATTTCGTGCACCACGATGCCCCCCGTGACC
CGGCGGAGCGGAACTCGCTAATAGGGAAAT|GTCGCATGGGAATGGTTCGAGCTCGTTCTA
ACATGCACGGCATAGCTTCTAGAACCCCAC|GTATAGATCATTTCTCCTCATGAATTCGAC
AATGTTAACTATCCTCTTTGCATAAACGAG|TCGGACATCTAACGATACTACCCATTAATT
AACTTTAACTATCCTCTTTGCATAAACGAG|TCCTCTTTGCATAAACGAGCCCTATACAAG
AGGCTCGATTAACTATCCTCTTTGCATAAA|GCAGACGCTGATAAGGGGGCTGAAGCTGCA
TTAACTATCTTAACTATCCTCTTTGCATAA|AGTGCGTGCCACGGGCTACTTCGTAGCCCC
CCTATAGGAGTGTTTCCACCGATTATCTTA|AACTATCCTCTTTGCATAAACGAGCCCTAA
AAGCGGACTAGGCTCGATTAACTATCCTCT|GCGGTGAGTGCAGACGCTGATAAGGGGGCT
ATAGCTTCTAGAACCCCACGCTCCCACTGA|TTCTCCTCATGAATTCGACAACCCAACCAT
CCACATTACATACACTACGAAGCGGTGAGT|TCATAAGGACGCATGGACAAGCGGCACCAG
CCACGATGCCCCCCGTGACCACATTACATA|CCCGGCCTCTAAATGGCCTCATAAGGACGC
TTACGTTAGTGTCGCATGGGAATGGTTCGA|TCCTCTTTGCATAAACGAGCCCTCCTCTTT
GGCAGCAGGATAAAGCGGACTAGGCTCGAT|ATACACTACGAAGCGGTGAGTGCAGACGCT
TATCCTCTTTGCATAAACGAGCCCTGTTTA|TCGGCGGAGCGGAACTCGCTAATAGGGAAA
GGCACCAGGAACCATTAATGTTAACTATCC|TCCCTCTGATAATCCATCGGACATCTAACG
CCTCTTTGCATAAACGAGCCCTGCCCTCTT|TCGTTTGGGAACTTTAACTATTTAACTATC
AACTATCCTCTTTGCATAAACGAGCCCTGT|AACTCGGCGGAGCGGAACTCGCTAATAGGG
TAAGTACTGTGCCGGCACGAGCGAAATGGA|GTTTCAGACACTATTGTACGCGTGCAGCCG
CCCCCGTGACCACATTACATACACTACGAA|TAAATGGCCTCATAAGGACGCATGGACAAG
ACCCCACGCTCCCACTGAAAGGGTCTTAAC|ATTCGACAACCCAACCATAGCGGAAGATCC
CCGGCCTCTAAATGGCCTCATAAGGACGCA|CGCTTAACTATCCTCTTTGCATAAACGAGC
TTCGTATATGTCGGAGACTCTCGCTTTAAG|TTACGGCGCCTTTAGTGCCTCTTTGTGTTT
CACGGGCTACTTCGTAGCCCCGCCGAATCA|CTTTAACTATCCTCTTTGCATAAACGAGCC
CGAGAACGGTTCTTAACTATCCTCTTTGCA|ACGAGCCCTATAGGAGTGTTTCCACCGATT
TCTTTGCATAAACGAGCCCTGTTTAGTCCC|GGAGCGGAACTCGCTAATAGGGAAATTAAC
CTTACGTTAGTGTCGCATGGGAATGGTTCG|ATCCTCTTTGCATAAACGAGCCCTCCTCTT
CCGCGTCAGATAGCAACTGACAATTTCTAG|GAGACTCTCGCTTTAAGTACTGTGCCGGCA
TGCACGGCATAGCTTCTAGAACCCCACGCT|TAGATCATTTCTCCTCATGAATTCGACAAC
CTAGTCCCACGGCAGCAGGATAAAGCGGAC|ACCACATTACATACACTACGAAGCGGTGAG
GCGGACTAGGCTCGATTAACTATCCTCTTT|GGTGAGTGCAGACGCTGATAAGGGGGCTGA
GTGCCGGCACGAGCGAAATGGAGTTGGGTT|CACTATTGTACGCGTGCAGCCGATCTAAGT
AACGAGCCCTCCTCTTTGCATAAACGAGCC|AACCCCACGCTCCCACTGAAAGGGTCTTAA
GGCGCGCTTAACTATCCTCTTTGCATAAAC|AGACGGTACAACTCGGCGGAGCGGAACTCG
GCACCCAAACTCGTACACATGCACGGCATA|CTAGGAGTGCTTACTTGTATAGATCATTTC
CGCGCGCGCTAGCCAGGCAATTATTTCGTG|TATCCTCTTTGCATAAACGAGCCCTAGCGA
CGAAAGCGACGAAGCTTAACTATCCTCTTT|CGCTAGCCAGGCAATTATTTCGTGCACCAC
GCTTCTCCCGCGGAATCGTTTGGGAACTTT|TTGCATAAACGAGCCCTTGCACCCAAACTC
ACCGATTATCTTATGTCGATGGCGGCGCGC|AAACGAGCCCTAACGCGCGATCTAGACGGT
GTGACCACATTACATACACTACGAAGCGGT|GGCCTCATAAGGACGCATGGACAAGCGGCA
TTAACTATCCTCTTTGCATAAACGAGCCCT|TCTCGCCTTCATAGCAGCAGACGGTGATGC
TAGGAGTGCTTACTTGTATAGATCATTTCT|GCACGAGCGAAATGGAGTTGGGTTTCTGGC
TAACTATCCTCTTTGCATAAACGAGCCCTA|TTTGCATAAACGAGCCCTATACAAGTTTCC
GAGTGCAGACGCTGATAAGGGGGCTGAAGC|CCAGGAACCATTAATGTTAACTATCCTCTT
CCCCCCGTGACCACATTACATACACTACGA|CTAAATGGCCTCATAAGGACGCATGGACAA
CTAGCGAGTCCCGGCCTCTAAATGGCCTCA|GATGGCGGCGCGCTTAACTATCCTCTTTGC
CCTGCGACATTGCTTTACGGCGCCTTTAGT|TGCAAACAATTGGCCTGTCCTTAGTACACC
CCCATTAATTTAACTATCCTCTTTGCATAA|CTCTCTTTGCATAAACGATTAACTATCCTC
CCCCGTGACCACATTACATACACTACGAAG|AAATGGCCTCATAAGGACGCATGGACAAGC
CTACTTCGTAGCCCCGCCGAATCAGACGCC|CTATCCTCTTTGCATAAACGAGCCCTATCC
CTTCTAGAACCCCACGCTCCCACTGAAAGG|CCTCATGAATTCGACAACCCAACCATAGCG
CATCGGACATCTAACGATACTACCCATTAA|ATCCTCTTTGCATAAACGAGCCCTCTCTTT
ATAGGGAAATTAACTATCTTAACTATCCTC|GCTCGTTCTAGTGCGTGCCACGGGCTACTT
TAAACGAGCCCTGCGACATTGCTTTACGGC|AGACGGTGATGCAAACAATTGGCCTGTCCT
CGAGCCCTTGCACCCAAACTCGTACACATG|TGACAATTTCTAGGAGTGCTTACTTGTATA
GATCTAGACGGTACAACTCGGCGGAGCGGA|CTGCCCTCTTACGTTAGTGTCGCATGGGAA
TAGGAGTGTTTCCACCGATTATCTTATGTC|ATCCTCTTTGCATAAACGAGCCCTAACGCG
AAACGAGCCCTCCCTTAAAGTATCGCGCGC|GCAGGACGAGAACGGTTCTTAACTATCCTC
CCGATTATCTTATGTCGATGGCGGCGCGCT|AACGAGCCCTAACGCGCGATCTAGACGGTA
AGCCCGAGACGATTAACTATCCTCTTTGCA|GTTTACGCCGCGTCTCGCCTTCATAGCAGC
TCCTCTTTGCATAAACGAGCCCTAACGCGC|GATTAACTATCCTCTTTGCATAAACGAGCC
TTAATGTTAACTATCCTCTTTGCATAAACG|CATCGGACATCTAACGATACTACCCATTAA
ATGGGAATGGTTCGAGCTCGTTCTAGTGCG|CGAGCCCTCCTCTTTGCATAAACGAGCCCT
CTCTTACGTTAGTGTCGCATGGGAATGGTT|CTATCCTCTTTGCATAAACGAGCCCTCCTC
GCCCACGCTTCTCCCGCGGAATCGTTTGGG|TCCTCTTTGCATAAACGAGCCCTTGCACCC
TGTTAACTATCCTCTTTGCATAAACGAGCC|GGACATCTAACGATACTACCCATTAATTTA
TGCCCCCCGTGACCACATTACATACACTAC|CTCTAAATGGCCTCATAAGGACGCATGGAC
TTTCTCCTCATGAATTCGACAACCCAACCA|CTGGCTCCATTCAGCCCGAGACGATTAACT
AACGATACTACCCATTAATTTAACTATCCT|TAAACGAGCCCTCTCTTTGCATAAACGATT
CTCGCTAATAGGGAAATTAACTATCTTAAC|GGTTCGAGCTCGTTCTAGTGCGTGCCACGG
CGAGCCCTGTTTAGTCCCTCTGATAATCCA|GCTAATAGGGAAATTAACTATCTTAACTAT
GCTCCCACTGAAAGGGTCTTAACTATCCTC|AACCCAACCATAGCGGAAGATCCTGCCTGT
CACATGCACGGCATAGCTTCTAGAACCCCA|TGTATAGATCATTTCTCCTCATGAATTCGA
GGCATAGCTTCTAGAACCCCACGCTCCCAC|CATTTCTCCTCATGAATTCGACAACCCAAC
CGGAATCGTTTGGGAACTTTAACTATTTAA|GAGCCCTTGCACCCAAACTCGTACACATGC
TATCCTCTTTGCATAAACGAGCCCTGCCCT|GAATCGTTTGGGAACTTTAACTATTTAACT
CATAAACGAGCCCTCTCTTTGCATAAACGA|GCCCCGCCGAATCAGACGCCCACGCTTCTC
GATTAACTATCCTCTTTGCATAAACGAGCC|CGTCTCGCCTTCATAGCAGCAGACGGTGAT
AAGCTGCAGGACGAGAACGGTTCTTAACTA|TCTTTGCATAAACGAGCCCTATAGGAGTGT
GGAATGGTTCGAGCTCGTTCTAGTGCGTGC|GCCCTCCTCTTTGCATAAACGAGCCCTTAA
CGAGCTCGTTCTAGTGCGTGCCACGGGCTA|TTTGCATAAACGAGCCCTTAACTTTAACTA
CAGACGCCCACGCTTCTCCCGCGGAATCGT|CCCTATCCTCTTTGCATAAACGAGCCCTTG
AATTATTTCGTGCACCACGATGCCCCCCGT|GAGCCCTAGCGAGTCCCGGCCTCTAAATGG
GAGCCCTAGCGAGTCCCGGCCTCTAAATGG|ATGTCGATGGCGGCGCGCTTAACTATCCTC
GGGGCTGAAGCTGCAGGACGAGAACGGTTC|ACTATCCTCTTTGCATAAACGAGCCCTATA
CGGCGCGCTTAACTATCCTCTTTGCATAAA|TAGACGGTACAACTCGGCGGAGCGGAACTC
GTTCGAGCTCGTTCTAGTGCGTGCCACGGG|CTCTTTGCATAAACGAGCCCTTAACTTTAA
CAAGCGGCACCAGGAACCATTAATGTTAAC|TTTAGTCCCTCTGATAATCCATCGGACATC
AATCCATCGGACATCTAACGATACTACCCA|AACTATCCTCTTTGCATAAACGAGCCCTCT
TAACTATCCTCTTTGCATAAACGAGCCCTC|ACGGGCTACTTCGTAGCCCCGCCGAATCAG
ACTATCCTCTTTGCATAAACGAGCCCTATC|TGCATAAACGAGCCCTATACAAGTTTCCGC
AAACGAGCCCTTGCACCCAAACTCGTACAC|AACTGACAATTTCTAGGAGTGCTTACTTGT
ATTAATGTTAACTATCCTCTTTGCATAAAC|CCATCGGACATCTAACGATACTACCCATTA
TAGATCATTTCTCCTCATGAATTCGACAAC|TGGGTTTCTGGCTCCATTCAGCCCGAGACG
TGTGCGCCGCTATCCAACTTCGTATATGTC|GAGCCCTGCGACATTGCTTTACGGCGCCTT
GCCGAATCAGACGCCCACGCTTCTCCCGCG|AAACGAGCCCTATCCTCTTTGCATAAACGA
GCGATCTAGACGGTACAACTCGGCGGAGCG|CCCTGCCCTCTTACGTTAGTGTCGCATGGG
ACAACTCGGCGGAGCGGAACTCGCTAATAG|GTTAGTGTCGCATGGGAATGGTTCGAGCTC
AAACGAGCCCTAGCGAGTCCCGGCCTCTAA|TCTTATGTCGATGGCGGCGCGCTTAACTAT
TGCATAAACGAGCCCTTGCACCCAAACTCG|ATAGCAACTGACAATTTCTAGGAGTGCTTA
ATAAACGAGCCCTATACAAGTTTCCGCGTC|GCTATCCAACTTCGTATATGTCGGAGACTC
TAGACGGTACAACTCGGCGGAGCGGAACTC|CCTCTTACGTTAGTGTCGCATGGGAATGGT
GGTTCGAGCTCGTTCTAGTGCGTGCCACGG|CCTCTTTGCATAAACGAGCCCTTAACTTTA
TTAATTTAACTATCCTCTTTGCATAAACGA|CTTTGCATAAACGATTAACTATCCTCTTTG
GCTATCCAACTTCGTATATGTCGGAGACTC|CGACATTGCTTTACGGCGCCTTTAGTGCCT
CGTGACCACATTACATACACTACGAAGCGG|TGGCCTCATAAGGACGCATGGACAAGCGGC
CCTCTTTGCATAAACGAGCCCTGCGACATT|TCATAGCAGCAGACGGTGATGCAAACAATT
GCCTTTAGTGCCTCTTTGTGTTTCAGACAC|TAGTACACCATGACCCGCTAGCAATCAGTA
TCTTTGCATAAACGAGCCCTAGTCCCACGG|ACCACGATGCCCCCCGTGACCACATTACAT
CTTTGCATAAACGAGCCCTATCCTCTTTGC|CGAGCCCTATACAAGTTTCCGCGTCAGATA
CTGTGCGCCGCTATCCAACTTCGTATATGT|CGAGCCCTGCGACATTGCTTTACGGCGCCT
AGCGAGTCCCGGCCTCTAAATGGCCTCATA|TGGCGGCGCGCTTAACTATCCTCTTTGCAT
AAAGCGGACTAGGCTCGATTAACTATCCTC|AGCGGTGAGTGCAGACGCTGATAAGGGGGC
TCTAGACGGTACAACTCGGCGGAGCGGAAC|GCCCTCTTACGTTAGTGTCGCATGGGAATG
CCTCTGATAATCCATCGGACATCTAACGAT|ACTATCTTAACTATCCTCTTTGCATAAACG
CGCCGAATCAGACGCCCACGCTTCTCCCGC|TAAACGAGCCCTATCCTCTTTGCATAAACG
TAAACGAGCCCTATCCTCTTTGCATAAACG|TATACAAGTTTCCGCGTCAGATAGCAACTG
CTTTGCATAAACGAGCCCTCTCTTTGCATA|TCGTAGCCCCGCCGAATCAGACGCCCACGC
ACGATTAACTATCCTCTTTGCATAAACGAG|CGCGTCTCGCCTTCATAGCAGCAGACGGTG
TACAACTCGGCGGAGCGGAACTCGCTAATA|CGTTAGTGTCGCATGGGAATGGTTCGAGCT
CGGAGCGGAACTCGCTAATAGGGAAATTAA|GCATGGGAATGGTTCGAGCTCGTTCTAGTG
CCCTCTTACGTTAGTGTCGCATGGGAATGG|AACTATCCTCTTTGCATAAACGAGCCCTCC
AACGGTTCTTAACTATCCTCTTTGCATAAA|GCCCTATAGGAGTGTTTCCACCGATTATCT
GAAGCTGCAGGACGAGAACGGTTCTTAACT|CTCTTTGCATAAACGAGCCCTATAGGAGTG
GCATAAACGAGCCCTGCGACATTGCTTTAC|AGCAGACGGTGATGCAAACAATTGGCCTGT
TCCCACTGAAAGGGTCTTAACTATCCTCTT|CCCAACCATAGCGGAAGATCCTGCCTGTGC
GAAGATCCTGCCTGTGCGCCGCTATCCAAC|CTTTGCATAAACGAGCCCTGCGACATTGCT
TCGATTAACTATCCTCTTTGCATAAACGAG|ACGCTGATAAGGGGGCTGAAGCTGCAGGAC
TTGCATAAACGAGCCCTTAACTTTAACTAT|CTGAAAGGGTCTTAACTATCCTCTTTGCAT
ACGAGCCCTATAGGAGTGTTTCCACCGATT|TAATTTAACTATCCTCTTTGCATAAACGAG
TAAGGACGCATGGACAAGCGGCACCAGGAA|ATAAACGAGCCCTGTTTAGTCCCTCTGATA
TTAACTTTAACTATCCTCTTTGCATAAACG|TATCCTCTTTGCATAAACGAGCCCTATACA
TAACGATACTACCCATTAATTTAACTATCC|ATAAACGAGCCCTCTCTTTGCATAAACGAT
GATGGCGGCGCGCTTAACTATCCTCTTTGC|CGATCTAGACGGTACAACTCGGCGGAGCGG
ATACAAGTTTCCGCGTCAGATAGCAACTGA|GTATATGTCGGAGACTCTCGCTTTAAGTAC
TAAACGAGCCCTTGCACCCAAACTCGTACA|CAACTGACAATTTCTAGGAGTGCTTACTTG
GCGGCACCAGGAACCATTAATGTTAACTAT|AGTCCCTCTGATAATCCATCGGACATCTAA
GTCAACAATCCTACGAAAGCGACGAAGCTT|AAAGTATCGCGCGCGCTAGCCAGGCAATTA
TCCTCTTTGCATAAACGAGCCCTCCCTTAA|GGGGCTGAAGCTGCAGGACGAGAACGGTTC
ATAAAGCGGACTAGGCTCGATTAACTATCC|GAAGCGGTGAGTGCAGACGCTGATAAGGGG
TAACTATCCTCTTTGCATAAACGAGCCCTG|CGCGGAATCGTTTGGGAACTTTAACTATTT
AAGGGTCTTAACTATCCTCTTTGCATAAAC|AGCGGAAGATCCTGCCTGTGCGCCGCTATC
ATCTTATGTCGATGGCGGCGCGCTTAACTA|CCCTAACGCGCGATCTAGACGGTACAACTC
GCTTTACGGCGCCTTTAGTGCCTCTTTGTG|GGCCTGTCCTTAGTACACCATGACCCGCTA
GCCCTGCGACATTGCTTTACGGCGCCTTTA|GATGCAAACAATTGGCCTGTCCTTAGTACA
CGACAACCCAACCATAGCGGAAGATCCTGC|CGAGACGATTAACTATCCTCTTTGCATAAA
TATCCTCTTTGCATAAACGAGCCCTAGCGA|GTTTCCACCGATTATCTTATGTCGATGGCG
CATAAACGAGCCCTCCTCTTTGCATAAACG|CTAGAACCCCACGCTCCCACTGAAAGGGTC
GGAGTGCTTACTTGTATAGATCATTTCTCC|ACGAGCGAAATGGAGTTGGGTTTCTGGCTC
CCACTGAAAGGGTCTTAACTATCCTCTTTG|CAACCATAGCGGAAGATCCTGCCTGTGCGC
CATAAACGAGCCCTAGTCCCACGGCAGCAG|ATGCCCCCCGTGACCACATTACATACACTA
CCTAGCGAGTCCCGGCCTCTAAATGGCCTC|CGATGGCGGCGCGCTTAACTATCCTCTTTG
GCTCGTTCTAGTGCGTGCCACGGGCTACTT|GCATAAACGAGCCCTTAACTTTAACTATCC
ACTGACAATTTCTAGGAGTGCTTACTTGTA|AGTACTGTGCCGGCACGAGCGAAATGGAGT
CGCGCTAGCCAGGCAATTATTTCGTGCACC|CTCTTTGCATAAACGAGCCCTAGCGAGTCC
TGCGTGCCACGGGCTACTTCGTAGCCCCGC|CCCTTAACTTTAACTATCCTCTTTGCATAA
TCTAGAACCCCACGCTCCCACTGAAAGGGT|TCATGAATTCGACAACCCAACCATAGCGGA
CCTGCCCTCTTACGTTAGTGTCGCATGGGA|ATTTAACTATCCTCTTTGCATAAACGAGCC
TAAATGGCCTCATAAGGACGCATGGACAAG|TATCCTCTTTGCATAAACGAGCCCTGTTTA
ATCCTCTTTGCATAAACGAGCCCTAGTCCC|GTGCACCACGATGCCCCCCGTGACCACATT
ATTCAGCCCGAGACGATTAACTATCCTCTT|TTGAGTTTACGCCGCGTCTCGCCTTCATAG
AGTCCCACGGCAGCAGGATAAAGCGGACTA|CACATTACATACACTACGAAGCGGTGAGTG
TTTGCATAAACGAGCCCTCCCTTAAAGTAT|TGAAGCTGCAGGACGAGAACGGTTCTTAAC
TTTGCATAAACGAGCCCTAACGCGCGATCT|ACTATCCTCTTTGCATAAACGAGCCCTGCC
CCTCTTTGCATAAACGAGCCCTTAACTTTA|TCCCACTGAAAGGGTCTTAACTATCCTCTT
GGAGTTGGGTTTCTGGCTCCATTCAGCCCG|CCGATCTAAGTTCACTAACCTTGAGTTTAC
CGAGCCCTAACGCGCGATCTAGACGGTACA|TTGCATAAACGAGCCCTGCCCTCTTACGTT
ACTATCCTCTTTGCATAAACGAGCCCTGCC|CGGAATCGTTTGGGAACTTTAACTATTTAA
TATCCTCTTTGCATAAACGAGCCCTCCTCT|CGGCATAGCTTCTAGAACCCCACGCTCCCA
TTTAACTATTTAACTATCCTCTTTGCATAA|CTCGTACACATGCACGGCATAGCTTCTAGA
ATGGACAAGCGGCACCAGGAACCATTAATG|CCCTGTTTAGTCCCTCTGATAATCCATCGG
TACCCATTAATTTAACTATCCTCTTTGCAT|CCCTCTCTTTGCATAAACGATTAACTATCC
TAGCCCCGCCGAATCAGACGCCCACGCTTC|TTTGCATAAACGAGCCCTATCCTCTTTGCA
AGACGGTACAACTCGGCGGAGCGGAACTCG|CTCTTACGTTAGTGTCGCATGGGAATGGTT
GAGCCCTTAACTTTAACTATCCTCTTTGCA|CTTAACTATCCTCTTTGCATAAACGAGCCC
TCTAGGAGTGCTTACTTGTATAGATCATTT|CGGCACGAGCGAAATGGAGTTGGGTTTCTG
TGCATAAACGAGCCCTATCCTCTTTGCATA|GCCCTATACAAGTTTCCGCGTCAGATAGCA
ATTCGACAACCCAACCATAGCGGAAGATCC|GCCCGAGACGATTAACTATCCTCTTTGCAT
AACTCGCTAATAGGGAAATTAACTATCTTA|ATGGTTCGAGCTCGTTCTAGTGCGTGCCAC
CTGAAAGGGTCTTAACTATCCTCTTTGCAT|CCATAGCGGAAGATCCTGCCTGTGCGCCGC
CCTGCCTGTGCGCCGCTATCCAACTTCGTA|ATAAACGAGCCCTGCGACATTGCTTTACGG
CCCTAGTCCCACGGCAGCAGGATAAAGCGG|TGACCACATTACATACACTACGAAGCGGTG
AACGAGCCCTAGCGAGTCCCGGCCTCTAAA|CTTATGTCGATGGCGGCGCGCTTAACTATC
ACTATCCTCTTTGCATAAACGAGCCCTATA|TCTAACGATACTACCCATTAATTTAACTAT
GCGTCAGATAGCAACTGACAATTTCTAGGA|GACTCTCGCTTTAAGTACTGTGCCGGCACG
GCGCGATCTAGACGGTACAACTCGGCGGAG|AGCCCTGCCCTCTTACGTTAGTGTCGCATG
TAATTTAACTATCCTCTTTGCATAAACGAG|TTTGCATAAACGATTAACTATCCTCTTTGC
CTTCTCCCGCGGAATCGTTTGGGAACTTTA|TGCATAAACGAGCCCTTGCACCCAAACTCG
TAAACGAGCCCTGTTTAGTCCCTCTGATAA|ACTCGCTAATAGGGAAATTAACTATCTTAA
TACACATGCACGGCATAGCTTCTAGAACCC|CTTGTATAGATCATTTCTCCTCATGAATTC
TCTCGCTTTAAGTACTGTGCCGGCACGAGC|CTCTTTGTGTTTCAGACACTATTGTACGCG
AGCGGAAGATCCTGCCTGTGCGCCGCTATC|TCCTCTTTGCATAAACGAGCCCTGCGACAT
AACGAGCCCTGCCCTCTTACGTTAGTGTCG|TTTAACTATTTAACTATCCTCTTTGCATAA
CAGATAGCAACTGACAATTTCTAGGAGTGC|CTCGCTTTAAGTACTGTGCCGGCACGAGCG
TATTTCGTGCACCACGATGCCCCCCGTGAC|CCCTAGCGAGTCCCGGCCTCTAAATGGCCT
TCTTTGCATAAACGAGCCCTATCCTCTTTG|ACGAGCCCTATACAAGTTTCCGCGTCAGAT
TCTTAACTATCCTCTTTGCATAAACGAGCC|TAGGAGTGTTTCCACCGATTATCTTATGTC
ATTAACTATCCTCTTTGCATAAACGAGCCC|GTCTCGCCTTCATAGCAGCAGACGGTGATG
TTAACTATCCTCTTTGCATAAACGAGCCCT|CCGCGGAATCGTTTGGGAACTTTAACTATT
ATTTCTCCTCATGAATTCGACAACCCAACC|TCTGGCTCCATTCAGCCCGAGACGATTAAC
ATAAACGAGCCCTAGCGAGTCCCGGCCTCT|TATCTTATGTCGATGGCGGCGCGCTTAACT
ATGTCAACAATCCTACGAAAGCGACGAAGC|TTAAAGTATCGCGCGCGCTAGCCAGGCAAT
AGCCCTAACGCGCGATCTAGACGGTACAAC|GCATAAACGAGCCCTGCCCTCTTACGTTAG
CTGATAAGGGGGCTGAAGCTGCAGGACGAG|TAATGTTAACTATCCTCTTTGCATAAACGA
CACCGATTATCTTATGTCGATGGCGGCGCG|TAAACGAGCCCTAACGCGCGATCTAGACGG
AACTATCCTCTTTGCATAAACGAGCCCTCC|GCACGGCATAGCTTCTAGAACCCCACGCTC
GCATAAACGAGCCCTTAACTTTAACTATCC|GAAAGGGTCTTAACTATCCTCTTTGCATAA
TAACTATCCTCTTTGCATAAACGAGCCCTA|GAGTGTTTCCACCGATTATCTTATGTCGAT
AACTTTAACTATTTAACTATCCTCTTTGCA|AAACTCGTACACATGCACGGCATAGCTTCT
AACGAGCCCTATAGGAGTGTTTCCACCGAT|TTAATTTAACTATCCTCTTTGCATAAACGA
AGCGAAATGGAGTTGGGTTTCTGGCTCCAT|GCGTGCAGCCGATCTAAGTTCACTAACCTT
CGATCTAGACGGTACAACTCGGCGGAGCGG|CCTGCCCTCTTACGTTAGTGTCGCATGGGA
ATCCATCGGACATCTAACGATACTACCCAT|ACTATCCTCTTTGCATAAACGAGCCCTCTC
CTATCCTCTTTGCATAAACGAGCCCTATCC|GCATAAACGAGCCCTATACAAGTTTCCGCG
GAAAGGGTCTTAACTATCCTCTTTGCATAA|ATAGCGGAAGATCCTGCCTGTGCGCCGCTA
TCGGCGGAGCGGAACTCGCTAATAGGGAAA|TGTCGCATGGGAATGGTTCGAGCTCGTTCT
AACCCAACCATAGCGGAAGATCCTGCCTGT|ACGATTAACTATCCTCTTTGCATAAACGAG
CTTCGTATATGTCGGAGACTCTCGCTTTAA|TTTACGGCGCCTTTAGTGCCTCTTTGTGTT
CCAGGAACCATTAATGTTAACTATCCTCTT|TCTGATAATCCATCGGACATCTAACGATAC
TTCGAGCTCGTTCTAGTGCGTGCCACGGGC|TCTTTGCATAAACGAGCCCTTAACTTTAAC
CTCTTTGCATAAACGAGCCCTAGTCCCACG|CACCACGATGCCCCCCGTGACCACATTACA
TCGGAGACTCTCGCTTTAAGTACTGTGCCG|TTTAGTGCCTCTTTGTGTTTCAGACACTAT
CCTCTTTGCATAAACGAGCCCTCCCTTAAA|GGGCTGAAGCTGCAGGACGAGAACGGTTCT
CTCCCGCGGAATCGTTTGGGAACTTTAACT|ATAAACGAGCCCTTGCACCCAAACTCGTAC
GCCTCTAAATGGCCTCATAAGGACGCATGG|TTAACTATCCTCTTTGCATAAACGAGCCCT
TTTGCATAAACGAGCCCTTGCACCCAAACT|AGATAGCAACTGACAATTTCTAGGAGTGCT
ATATGTCGGAGACTCTCGCTTTAAGTACTG|GCGCCTTTAGTGCCTCTTTGTGTTTCAGAC
CTGGCTCCATTCAGCCCGAGACGATTAACT|CACTAACCTTGAGTTTACGCCGCGTCTCGC
GGCGGAGCGGAACTCGCTAATAGGGAAATT|TCGCATGGGAATGGTTCGAGCTCGTTCTAG
CGGAAGATCCTGCCTGTGCGCCGCTATCCA|CTCTTTGCATAAACGAGCCCTGCGACATTG
TAAACGAGCCCTATAGGAGTGTTTCCACCG|CATTAATTTAACTATCCTCTTTGCATAAAC
GCGCGCGCTAGCCAGGCAATTATTTCGTGC|ATCCTCTTTGCATAAACGAGCCCTAGCGAG
CGGTACAACTCGGCGGAGCGGAACTCGCTA|TTACGTTAGTGTCGCATGGGAATGGTTCGA
CGCTGATAAGGGGGCTGAAGCTGCAGGACG|ATTAATGTTAACTATCCTCTTTGCATAAAC
CTAGCCAGGCAATTATTTCGTGCACCACGA|TTGCATAAACGAGCCCTAGCGAGTCCCGGC
TGGAGTTGGGTTTCTGGCTCCATTCAGCCC|GCCGATCTAAGTTCACTAACCTTGAGTTTA
TTAACTATCCTCTTTGCATAAACGAGCCCT|ACAACTCGGCGGAGCGGAACTCGCTAATAG
AGGGGGCTGAAGCTGCAGGACGAGAACGGT|TAACTATCCTCTTTGCATAAACGAGCCCTA
ACGAGCCCTCCCTTAAAGTATCGCGCGCGC|AGGACGAGAACGGTTCTTAACTATCCTCTT
TAGTGTCGCATGGGAATGGTTCGAGCTCGT|TTGCATAAACGAGCCCTCCTCTTTGCATAA
AGCCCTAGCGAGTCCCGGCCTCTAAATGGC|TGTCGATGGCGGCGCGCTTAACTATCCTCT
GCATAAACGAGCCCTAACGCGCGATCTAGA|ATCCTCTTTGCATAAACGAGCCCTGCCCTC
CCCTATAGGAGTGTTTCCACCGATTATCTT|TAACTATCCTCTTTGCATAAACGAGCCCTA
TTAACTATCCTCTTTGCATAAACGAGCCCT|CACGGGCTACTTCGTAGCCCCGCCGAATCA
AACTGACAATTTCTAGGAGTGCTTACTTGT|AAGTACTGTGCCGGCACGAGCGAAATGGAG
AGCCCTGCCCTCTTACGTTAGTGTCGCATG|ACTATTTAACTATCCTCTTTGCATAAACGA
CTTTGCATAAACGAGCCCTTAACTTTAACT|CACTGAAAGGGTCTTAACTATCCTCTTTGC
TGCATAAACGAGCCCTAGCGAGTCCCGGCC|GATTATCTTATGTCGATGGCGGCGCGCTTA
GGAAGATCCTGCCTGTGCGCCGCTATCCAA|TCTTTGCATAAACGAGCCCTGCGACATTGC
CTCGATTAACTATCCTCTTTGCATAAACGA|GACGCTGATAAGGGGGCTGAAGCTGCAGGA
CCACGCTCCCACTGAAAGGGTCTTAACTAT|CGACAACCCAACCATAGCGGAAGATCCTGC
TGGCTCCATTCAGCCCGAGACGATTAACTA|ACTAACCTTGAGTTTACGCCGCGTCTCGCC
CCCGGCCTCTAAATGGCCTCATAAGGACGC|GCGCTTAACTATCCTCTTTGCATAAACGAG
CCCGCGGAATCGTTTGGGAACTTTAACTAT|AAACGAGCCCTTGCACCCAAACTCGTACAC
TAAGGGGGCTGAAGCTGCAGGACGAGAACG|GTTAACTATCCTCTTTGCATAAACGAGCCC
CTTACTTGTATAGATCATTTCTCCTCATGA|GAAATGGAGTTGGGTTTCTGGCTCCATTCA
CGAGCGAAATGGAGTTGGGTTTCTGGCTCC|ACGCGTGCAGCCGATCTAAGTTCACTAACC
GACGGTACAACTCGGCGGAGCGGAACTCGC|TCTTACGTTAGTGTCGCATGGGAATGGTTC
CCCTCTGATAATCCATCGGACATCTAACGA|AACTATCTTAACTATCCTCTTTGCATAAAC
TAGCCAGGCAATTATTTCGTGCACCACGAT|TGCATAAACGAGCCCTAGCGAGTCCCGGCC
ACTACGAAGCGGTGAGTGCAGACGCTGATA|TGGACAAGCGGCACCAGGAACCATTAATGT
CCTAGTCCCACGGCAGCAGGATAAAGCGGA|GACCACATTACATACACTACGAAGCGGTGA
CAGGAACCATTAATGTTAACTATCCTCTTT|CTGATAATCCATCGGACATCTAACGATACT
CGATTAACTATCCTCTTTGCATAAACGAGC|CTCCCGCGGAATCGTTTGGGAACTTTAACT
GCAATTATTTCGTGCACCACGATGCCCCCC|ACGAGCCCTAGCGAGTCCCGGCCTCTAAAT
CCACCGATTATCTTATGTCGATGGCGGCGC|ATAAACGAGCCCTAACGCGCGATCTAGACG
AAACGAGCCCTAGTCCCACGGCAGCAGGAT|CCCCCCGTGACCACATTACATACACTACGA
CCCACGCTTCTCCCGCGGAATCGTTTGGGA|CCTCTTTGCATAAACGAGCCCTTGCACCCA
GAATTCGACAACCCAACCATAGCGGAAGAT|CAGCCCGAGACGATTAACTATCCTCTTTGC
CACGGCAGCAGGATAAAGCGGACTAGGCTC|TACATACACTACGAAGCGGTGAGTGCAGAC
TAAAGTATCGCGCGCGCTAGCCAGGCAATT|TTCTTAACTATCCTCTTTGCATAAACGAGC
TTTGGGAACTTTAACTATTTAACTATCCTC|GCACCCAAACTCGTACACATGCACGGCATA
GGCTGAAGCTGCAGGACGAGAACGGTTCTT|TATCCTCTTTGCATAAACGAGCCCTATAGG
TGCATAAACGAGCCCTGTTTAGTCCCTCTG|CGGAACTCGCTAATAGGGAAATTAACTATC
GAGCCCTGCGACATTGCTTTACGGCGCCTT|GTGATGCAAACAATTGGCCTGTCCTTAGTA
TCGCTAATAGGGAAATTAACTATCTTAACT|GTTCGAGCTCGTTCTAGTGCGTGCCACGGG
CGTTCTAGTGCGTGCCACGGGCTACTTCGT|TAAACGAGCCCTTAACTTTAACTATCCTCT
AACCCCACGCTCCCACTGAAAGGGTCTTAA|AATTCGACAACCCAACCATAGCGGAAGATC
TTAGTGTCGCATGGGAATGGTTCGAGCTCG|TTTGCATAAACGAGCCCTCCTCTTTGCATA
AACGAGCCCTGCGACATTGCTTTACGGCGC|ACGGTGATGCAAACAATTGGCCTGTCCTTA
TGTCGGAGACTCTCGCTTTAAGTACTGTGC|CCTTTAGTGCCTCTTTGTGTTTCAGACACT
GACAATTTCTAGGAGTGCTTACTTGTATAG|ACTGTGCCGGCACGAGCGAAATGGAGTTGG
AAACGAGCCCTATCCTCTTTGCATAAACGA|ATACAAGTTTCCGCGTCAGATAGCAACTGA
TTGCATAAACGAGCCCTGTTTAGTCCCTCT|GCGGAACTCGCTAATAGGGAAATTAACTAT
AGATCATTTCTCCTCATGAATTCGACAACC|GGGTTTCTGGCTCCATTCAGCCCGAGACGA
ATACACTACGAAGCGGTGAGTGCAGACGCT|CGCATGGACAAGCGGCACCAGGAACCATTA
ACTATCCTCTTTGCATAAACGAGCCCTGCG|CGCCTTCATAGCAGCAGACGGTGATGCAAA
AACTTCGTATATGTCGGAGACTCTCGCTTT|GCTTTACGGCGCCTTTAGTGCCTCTTTGTG
AGTCCCGGCCTCTAAATGGCCTCATAAGGA|GGCGCGCTTAACTATCCTCTTTGCATAAAC
ATGGTTCGAGCTCGTTCTAGTGCGTGCCAC|CTCCTCTTTGCATAAACGAGCCCTTAACTT
TTTCTGGCTCCATTCAGCCCGAGACGATTA|GTTCACTAACCTTGAGTTTACGCCGCGTCT
AGCCCCGCCGAATCAGACGCCCACGCTTCT|TTGCATAAACGAGCCCTATCCTCTTTGCAT
CTCTTTGCATAAACGAGCCCTATAGGAGTG|GATACTACCCATTAATTTAACTATCCTCTT
CAAACTCGTACACATGCACGGCATAGCTTC|AGTGCTTACTTGTATAGATCATTTCTCCTC
TTTGCATAAACGAGCCCTGCCCTCTTACGT|TTGGGAACTTTAACTATTTAACTATCCTCT
TCTTACGTTAGTGTCGCATGGGAATGGTTC|TATCCTCTTTGCATAAACGAGCCCTCCTCT
CTTTGCATAAACGAGCCCTCCCTTAAAGTA|CTGAAGCTGCAGGACGAGAACGGTTCTTAA
TGTATAGATCATTTCTCCTCATGAATTCGA|GAGTTGGGTTTCTGGCTCCATTCAGCCCGA
AGCCCTGCGACATTGCTTTACGGCGCCTTT|TGATGCAAACAATTGGCCTGTCCTTAGTAC
GCATAAACGAGCCCTATCCTCTTTGCATAA|CCCTATACAAGTTTCCGCGTCAGATAGCAA
TCTTAACTATCCTCTTTGCATAAACGAGCC|GCCACGGGCTACTTCGTAGCCCCGCCGAAT
TTCGACAACCCAACCATAGCGGAAGATCCT|CCCGAGACGATTAACTATCCTCTTTGCATA
CAACCCAACCATAGCGGAAGATCCTGCCTG|GACGATTAACTATCCTCTTTGCATAAACGA
GTGCACCACGATGCCCCCCGTGACCACATT|CGAGTCCCGGCCTCTAAATGGCCTCATAAG
ATCGCGCGCGCTAGCCAGGCAATTATTTCG|ACTATCCTCTTTGCATAAACGAGCCCTAGC
AGCCCTATAGGAGTGTTTCCACCGATTATC|TTTAACTATCCTCTTTGCATAAACGAGCCC
TTGCATAAACGAGCCCTCCCTTAAAGTATC|GAAGCTGCAGGACGAGAACGGTTCTTAACT
GCAGACGCTGATAAGGGGGCTGAAGCTGCA|GAACCATTAATGTTAACTATCCTCTTTGCA
GACAACCCAACCATAGCGGAAGATCCTGCC|GAGACGATTAACTATCCTCTTTGCATAAAC
AGCTGCAGGACGAGAACGGTTCTTAACTAT|CTTTGCATAAACGAGCCCTATAGGAGTGTT
ACGATACTACCCATTAATTTAACTATCCTC|AAACGAGCCCTCTCTTTGCATAAACGATTA
CTCTCGCTTTAAGTACTGTGCCGGCACGAG|CCTCTTTGTGTTTCAGACACTATTGTACGC
TGTTTCCACCGATTATCTTATGTCGATGGC|TTTGCATAAACGAGCCCTAACGCGCGATCT
TCTGATAATCCATCGGACATCTAACGATAC|TATCTTAACTATCCTCTTTGCATAAACGAG
TTCTCCCGCGGAATCGTTTGGGAACTTTAA|GCATAAACGAGCCCTTGCACCCAAACTCGT
CTCTTTGCATAAACGAGCCCTCCCTTAAAG|GGCTGAAGCTGCAGGACGAGAACGGTTCTT
CTGTGCCGGCACGAGCGAAATGGAGTTGGG|GACACTATTGTACGCGTGCAGCCGATCTAA
TTGCATAAACGAGCCCTATCCTCTTTGCAT|AGCCCTATACAAGTTTCCGCGTCAGATAGC
GTTTAGTCCCTCTGATAATCCATCGGACAT|GGAAATTAACTATCTTAACTATCCTCTTTG
