AGTTTAACGTCTCTTGAGAT -> GTTTAACGTCTCTTGAGATA
CAGTTTAACGTCTCTTGAGA -> AGTTTAACGTCTCTTGAGAT
AATAAGTCTACGTGTAGGAC -> ATAAGTCTACGTGTAGGACT
ATAAGTCTACGTGTAGGACT -> TAAGTCTACGTGTAGGACTC
AAGAATAAGTCTACGTGTAG -> AGAATAAGTCTACGTGTAGG
AGAATAAGTCTACGTGTAGG -> GAATAAGTCTACGTGTAGGA
GACTCGCTGTAATTTACAGT -> ACTCGCTGTAATTTACAGTC
ACTCGCTGTAATTTACAGTC -> CTCGCTGTAATTTACAGTCC
GCTGTCTGGAAGCGTAAACC -> CTGTCTGGAAGCGTAAACCA
CGCTGTCTGGAAGCGTAAAC -> GCTGTCTGGAAGCGTAAACC
ATAGCTTACAAACCAAGTGT -> TAGCTTACAAACCAAGTGTA
TATAGCTTACAAACCAAGTG -> ATAGCTTACAAACCAAGTGT
CCACTCTATGGCTATCTTTT -> CACTCTATGGCTATCTTTTA
CACTCTATGGCTATCTTTTA -> ACTCTATGGCTATCTTTTAC
TAGCTTACAAACCAAGTGTA -> AGCTTACAAACCAAGTGTAC
TGCGATCTCTGTGATTATAG -> GCGATCTCTGTGATTATAGC
CTGCGATCTCTGTGATTATA -> TGCGATCTCTGTGATTATAG
TACCCCTTAGAGTTCTTCAC -> ACCCCTTAGAGTTCTTCACG
ACCCCTTAGAGTTCTTCACG -> CCCCTTAGAGTTCTTCACGT
ATGGGTCCGCTTTAAGCGAA -> TGGGTCCGCTTTAAGCGAAA
TGGGTCCGCTTTAAGCGAAA -> GGGTCCGCTTTAAGCGAAAA
GTGACGGGAATTGTTTCGAC -> TGACGGGAATTGTTTCGACC
AGTGACGGGAATTGTTTCGA -> GTGACGGGAATTGTTTCGAC
ACTCTAAGCTTAGCTCGCTG -> CTCTAAGCTTAGCTCGCTGA
CTCTAAGCTTAGCTCGCTGA -> TCTAAGCTTAGCTCGCTGAC
TTAGCGAGGGCATTACAAAC -> TAGCGAGGGCATTACAAACG
TAGCGAGGGCATTACAAACG -> AGCGAGGGCATTACAAACGT
GTCTGGAAGCGTAAACCAAG -> TCTGGAAGCGTAAACCAAGA
TCTGGAAGCGTAAACCAAGA -> CTGGAAGCGTAAACCAAGAA
TGCGCAGCGTGGCCGCATGG -> GCGCAGCGTGGCCGCATGGG
GCGCAGCGTGGCCGCATGGG -> CGCAGCGTGGCCGCATGGGC
CCCGTCTAGTGGTAGCATAG -> CCGTCTAGTGGTAGCATAGA
CCGTCTAGTGGTAGCATAGA -> CGTCTAGTGGTAGCATAGAT
TGCAGCTATACCGTACGCCA -> GCAGCTATACCGTACGCCAC
GCAGCTATACCGTACGCCAC -> CAGCTATACCGTACGCCACT
TGTGTCAAAGATATATAGAC -> GTGTCAAAGATATATAGACT
ATGTGTCAAAGATATATAGA -> TGTGTCAAAGATATATAGAC
CTCAACACTAACAGTTTAAC -> TCAACACTAACAGTTTAACG
ACTCAACACTAACAGTTTAA -> CTCAACACTAACAGTTTAAC
GAATTGTTTCGACCTTATAG -> AATTGTTTCGACCTTATAGC
AATTGTTTCGACCTTATAGC -> ATTGTTTCGACCTTATAGCT
GTGGGCGCATCTCGACAATA -> TGGGCGCATCTCGACAATAC
TGGGCGCATCTCGACAATAC -> GGGCGCATCTCGACAATACA
GGGGACACCACCCGTTTTGG -> GGGACACCACCCGTTTTGGA
GGGACACCACCCGTTTTGGA -> GGACACCACCCGTTTTGGAC
GCTATCTTTTACTTGCGAAG -> CTATCTTTTACTTGCGAAGC
CTATCTTTTACTTGCGAAGC -> TATCTTTTACTTGCGAAGCT
ATTACAAACGTACAAAGTCA -> TTACAAACGTACAAAGTCAG
CATTACAAACGTACAAAGTC -> ATTACAAACGTACAAAGTCA
ACACTAACAGTTTAACGTCT -> CACTAACAGTTTAACGTCTC
AACACTAACAGTTTAACGTC -> ACACTAACAGTTTAACGTCT
ACAGGACCATCGGGCGTAAG -> CAGGACCATCGGGCGTAAGA
TACAGGACCATCGGGCGTAA -> ACAGGACCATCGGGCGTAAG
TCGCATAGAAGGGAAGTATT -> CGCATAGAAGGGAAGTATTC
CGCATAGAAGGGAAGTATTC -> GCATAGAAGGGAAGTATTCC
GCGTGGCCGCATGGGCCAAA -> CGTGGCCGCATGGGCCAAAG
CGTGGCCGCATGGGCCAAAG -> GTGGCCGCATGGGCCAAAGT
AGCTGCGATCTCTGTGATTA -> GCTGCGATCTCTGTGATTAT
GCTGCGATCTCTGTGATTAT -> CTGCGATCTCTGTGATTATA
GTGTACGTCTTTCTAGACCT -> TGTACGTCTTTCTAGACCTT
AGTGTACGTCTTTCTAGACC -> GTGTACGTCTTTCTAGACCT
CGACGCGTCTACCGGGCAAC -> GACGCGTCTACCGGGCAACT
GACGCGTCTACCGGGCAACT -> ACGCGTCTACCGGGCAACTG
GGCTATCTTTTACTTGCGAA -> GCTATCTTTTACTTGCGAAG
TGGCTATCTTTTACTTGCGA -> GGCTATCTTTTACTTGCGAA
AAGACTCAACACTAACAGTT -> AGACTCAACACTAACAGTTT
AGACTCAACACTAACAGTTT -> GACTCAACACTAACAGTTTA
CTCCGAGATATCAAGACTCA -> TCCGAGATATCAAGACTCAA
TCCGAGATATCAAGACTCAA -> CCGAGATATCAAGACTCAAC
ATATACGTCACCGCCACGCA -> TATACGTCACCGCCACGCAT
TATACGTCACCGCCACGCAT -> ATACGTCACCGCCACGCATG
AGCTATACCGTACGCCACTC -> GCTATACCGTACGCCACTCT
GCTATACCGTACGCCACTCT -> CTATACCGTACGCCACTCTA
TCTCATCATCACAGGCTGCC -> CTCATCATCACAGGCTGCCA
CTCATCATCACAGGCTGCCA -> TCATCATCACAGGCTGCCAC
AGAACTGAACGATCGCATAG -> GAACTGAACGATCGCATAGA
GAACTGAACGATCGCATAGA -> AACTGAACGATCGCATAGAA
TAGGACTCGCTGTAATTTAC -> AGGACTCGCTGTAATTTACA
GTAGGACTCGCTGTAATTTA -> TAGGACTCGCTGTAATTTAC
GTTTTGGACCGTCTAGCTGC -> TTTTGGACCGTCTAGCTGCG
CGTTTTGGACCGTCTAGCTG -> GTTTTGGACCGTCTAGCTGC
GCTACATAGCAGAGCCGGGT -> CTACATAGCAGAGCCGGGTT
TGCTACATAGCAGAGCCGGG -> GCTACATAGCAGAGCCGGGT
GTCAAAGATATATAGACTCT -> TCAAAGATATATAGACTCTA
TCAAAGATATATAGACTCTA -> CAAAGATATATAGACTCTAA
TATTACCCCTTAGAGTTCTT -> ATTACCCCTTAGAGTTCTTC
ATTACCCCTTAGAGTTCTTC -> TTACCCCTTAGAGTTCTTCA
TTGGCCAGGCGCATCAGTTT -> TGGCCAGGCGCATCAGTTTC
CTTGGCCAGGCGCATCAGTT -> TTGGCCAGGCGCATCAGTTT
GATGGGTCCGCTTTAAGCGA -> ATGGGTCCGCTTTAAGCGAA
CTGTTGGCTCTGCGATCTGT -> TGTTGGCTCTGCGATCTGTG
TGTTGGCTCTGCGATCTGTG -> GTTGGCTCTGCGATCTGTGG
ACGTCTCTTGAGATAGACGC -> CGTCTCTTGAGATAGACGCC
AACGTCTCTTGAGATAGACG -> ACGTCTCTTGAGATAGACGC
GCGTAAACCAAGAAAAACCG -> CGTAAACCAAGAAAAACCGG
AGCGTAAACCAAGAAAAACC -> GCGTAAACCAAGAAAAACCG
GCAGCAAACTGCTACATAGC -> CAGCAAACTGCTACATAGCA
CAGCAAACTGCTACATAGCA -> AGCAAACTGCTACATAGCAG
CAGGACCATCGGGCGTAAGA -> AGGACCATCGGGCGTAAGAA
GTCTCATCATCACAGGCTGC -> TCTCATCATCACAGGCTGCC
TGTCTCATCATCACAGGCTG -> GTCTCATCATCACAGGCTGC
GCTACACCTGTGGGCGCATC -> CTACACCTGTGGGCGCATCT
TGCTACACCTGTGGGCGCAT -> GCTACACCTGTGGGCGCATC
AACCAAGAAAAACCGGGCGT -> ACCAAGAAAAACCGGGCGTC
AAACCAAGAAAAACCGGGCG -> AACCAAGAAAAACCGGGCGT
CTTGTAAAAGTATTCTCAGA -> TTGTAAAAGTATTCTCAGAC
TTGTAAAAGTATTCTCAGAC -> TGTAAAAGTATTCTCAGACC
CACTGGTGCTTGTACTTGGC -> ACTGGTGCTTGTACTTGGCC
CCACTGGTGCTTGTACTTGG -> CACTGGTGCTTGTACTTGGC
CATCACAGGCTGCCACTGTC -> ATCACAGGCTGCCACTGTCA
ATCACAGGCTGCCACTGTCA -> TCACAGGCTGCCACTGTCAT
ACAAAGTCAGTCGCACATAC -> CAAAGTCAGTCGCACATACA
TACAAAGTCAGTCGCACATA -> ACAAAGTCAGTCGCACATAC
GTCTTCGTTCATTTTAGTGA -> TCTTCGTTCATTTTAGTGAC
CGTCTTCGTTCATTTTAGTG -> GTCTTCGTTCATTTTAGTGA
TGGCCAGGCGCATCAGTTTC -> GGCCAGGCGCATCAGTTTCA
CGCGCCATGCAGCTATACCG -> GCGCCATGCAGCTATACCGT
ACGCGCCATGCAGCTATACC -> CGCGCCATGCAGCTATACCG
GGTGCTTGTACTTGGCCAGG -> GTGCTTGTACTTGGCCAGGC
TGGTGCTTGTACTTGGCCAG -> GGTGCTTGTACTTGGCCAGG
GACGGGAATTGTTTCGACCT -> ACGGGAATTGTTTCGACCTT
TGACGGGAATTGTTTCGACC -> GACGGGAATTGTTTCGACCT
CCACGCATGCGCAGCGTGGC -> CACGCATGCGCAGCGTGGCC
GCCACGCATGCGCAGCGTGG -> CCACGCATGCGCAGCGTGGC
CCTAGTGGGAATCCAGCGAC -> CTAGTGGGAATCCAGCGACT
CTAGTGGGAATCCAGCGACT -> TAGTGGGAATCCAGCGACTA
GGGGTTTAAGTGGAGTTATA -> GGGTTTAAGTGGAGTTATAG
GGGTTTAAGTGGAGTTATAG -> GGTTTAAGTGGAGTTATAGA
TTTCGATAGGTGAGGCCGCG -> TTCGATAGGTGAGGCCGCGC
CTTTCGATAGGTGAGGCCGC -> TTTCGATAGGTGAGGCCGCG
TTCGATAGGTGAGGCCGCGC -> TCGATAGGTGAGGCCGCGCG
GGACATCAATATTACCCCTT -> GACATCAATATTACCCCTTA
TGGACATCAATATTACCCCT -> GGACATCAATATTACCCCTT
GTTCTTGTAAAAGTATTCTC -> TTCTTGTAAAAGTATTCTCA
TTCTTGTAAAAGTATTCTCA -> TCTTGTAAAAGTATTCTCAG
TCTATGGCTATCTTTTACTT -> CTATGGCTATCTTTTACTTG
CTCTATGGCTATCTTTTACT -> TCTATGGCTATCTTTTACTT
GCAGAATTTCGCTGTCTGGA -> CAGAATTTCGCTGTCTGGAA
TGCAGAATTTCGCTGTCTGG -> GCAGAATTTCGCTGTCTGGA
TTTCGACCTTATAGCTTACA -> TTCGACCTTATAGCTTACAA
TTCGACCTTATAGCTTACAA -> TCGACCTTATAGCTTACAAA
GTAGCATAGATGGGTCCGCT -> TAGCATAGATGGGTCCGCTT
GGTAGCATAGATGGGTCCGC -> GTAGCATAGATGGGTCCGCT
AAGGGAAGTATTCCTTTCGA -> AGGGAAGTATTCCTTTCGAT
AGGGAAGTATTCCTTTCGAT -> GGGAAGTATTCCTTTCGATA
GAGGGCATTACAAACGTACA -> AGGGCATTACAAACGTACAA
CGAGGGCATTACAAACGTAC -> GAGGGCATTACAAACGTACA
ATGGGCCAAAGTTAGCGAGG -> TGGGCCAAAGTTAGCGAGGG
CATGGGCCAAAGTTAGCGAG -> ATGGGCCAAAGTTAGCGAGG
TGGCTCTGCGATCTGTGGGG -> GGCTCTGCGATCTGTGGGGA
TTGGCTCTGCGATCTGTGGG -> TGGCTCTGCGATCTGTGGGG
CGGGAATTGTTTCGACCTTA -> GGGAATTGTTTCGACCTTAT
GGGAATTGTTTCGACCTTAT -> GGAATTGTTTCGACCTTATA
GAAGTATTCCTTTCGATAGG -> AAGTATTCCTTTCGATAGGT
AAGTATTCCTTTCGATAGGT -> AGTATTCCTTTCGATAGGTG
CACCTGTGGGCGCATCTCGA -> ACCTGTGGGCGCATCTCGAC
ACCTGTGGGCGCATCTCGAC -> CCTGTGGGCGCATCTCGACA
GGAATTGTTTCGACCTTATA -> GAATTGTTTCGACCTTATAG
CCGGGCAACTGTTGGCTCTG -> CGGGCAACTGTTGGCTCTGC
ACCGGGCAACTGTTGGCTCT -> CCGGGCAACTGTTGGCTCTG
CTATGGCTATCTTTTACTTG -> TATGGCTATCTTTTACTTGC
GTTTCGACCTTATAGCTTAC -> TTTCGACCTTATAGCTTACA
TGTTTCGACCTTATAGCTTA -> GTTTCGACCTTATAGCTTAC
CGCACATACAGGACCATCGG -> GCACATACAGGACCATCGGG
TCGCACATACAGGACCATCG -> CGCACATACAGGACCATCGG
AGTTATAGAGGGAGAACTGA -> GTTATAGAGGGAGAACTGAA
GAGTTATAGAGGGAGAACTG -> AGTTATAGAGGGAGAACTGA
GGCTCTGCGATCTGTGGGGA -> GCTCTGCGATCTGTGGGGAC
ATCTCGACAATACATCACAC -> TCTCGACAATACATCACACG
TCTCGACAATACATCACACG -> CTCGACAATACATCACACGC
GCATAGAAGGGAAGTATTCC -> CATAGAAGGGAAGTATTCCT
CATAGAAGGGAAGTATTCCT -> ATAGAAGGGAAGTATTCCTT
GTCTACGTGTAGGACTCGCT -> TCTACGTGTAGGACTCGCTG
TCTACGTGTAGGACTCGCTG -> CTACGTGTAGGACTCGCTGT
GTTAGCGAGGGCATTACAAA -> TTAGCGAGGGCATTACAAAC
AGTTAGCGAGGGCATTACAA -> GTTAGCGAGGGCATTACAAA
TCAACACTAACAGTTTAACG -> CAACACTAACAGTTTAACGT
CGCATGGGCCAAAGTTAGCG -> GCATGGGCCAAAGTTAGCGA
GCATGGGCCAAAGTTAGCGA -> CATGGGCCAAAGTTAGCGAG
TAGAGGGAGAACTGAACGAT -> AGAGGGAGAACTGAACGATC
AGAGGGAGAACTGAACGATC -> GAGGGAGAACTGAACGATCG
CGCTTTAAGCGAAAACGACC -> GCTTTAAGCGAAAACGACCC
CCGCTTTAAGCGAAAACGAC -> CGCTTTAAGCGAAAACGACC
AGGGAGAACTGAACGATCGC -> GGGAGAACTGAACGATCGCA
GAGGGAGAACTGAACGATCG -> AGGGAGAACTGAACGATCGC
ATAGACTCTAAGCTTAGCTC -> TAGACTCTAAGCTTAGCTCG
TATAGACTCTAAGCTTAGCT -> ATAGACTCTAAGCTTAGCTC
TAGCATAGATGGGTCCGCTT -> AGCATAGATGGGTCCGCTTT
AGCATAGATGGGTCCGCTTT -> GCATAGATGGGTCCGCTTTA
GCGTCTACCGGGCAACTGTT -> CGTCTACCGGGCAACTGTTG
CGTCTACCGGGCAACTGTTG -> GTCTACCGGGCAACTGTTGG
CCGCATGGGCCAAAGTTAGC -> CGCATGGGCCAAAGTTAGCG
ATCGCATAGAAGGGAAGTAT -> TCGCATAGAAGGGAAGTATT
GTCCGCTTTAAGCGAAAACG -> TCCGCTTTAAGCGAAAACGA
GGTCCGCTTTAAGCGAAAAC -> GTCCGCTTTAAGCGAAAACG
GCGCAGCAAACTGCTACATA -> CGCAGCAAACTGCTACATAG
AGCGCAGCAAACTGCTACAT -> GCGCAGCAAACTGCTACATA
TTCTTCACGTCGCACTGTCT -> TCTTCACGTCGCACTGTCTC
GTTCTTCACGTCGCACTGTC -> TTCTTCACGTCGCACTGTCT
TTACCCCTTAGAGTTCTTCA -> TACCCCTTAGAGTTCTTCAC
GAAAAACCGGGCGTCTTCGT -> AAAAACCGGGCGTCTTCGTT
AGAAAAACCGGGCGTCTTCG -> GAAAAACCGGGCGTCTTCGT
ACCATACAATACTCCATGCC -> CCATACAATACTCCATGCCG
CCATACAATACTCCATGCCG -> CATACAATACTCCATGCCGA
GCTTTAAGCGAAAACGACCC -> CTTTAAGCGAAAACGACCCA
TCGACGCGTCTACCGGGCAA -> CGACGCGTCTACCGGGCAAC
ATCAATATTACCCCTTAGAG -> TCAATATTACCCCTTAGAGT
TCAATATTACCCCTTAGAGT -> CAATATTACCCCTTAGAGTT
GTACTTGGCCAGGCGCATCA -> TACTTGGCCAGGCGCATCAG
TGTACTTGGCCAGGCGCATC -> GTACTTGGCCAGGCGCATCA
GCCACTGTCATCCGTTCGAC -> CCACTGTCATCCGTTCGACG
CCACTGTCATCCGTTCGACG -> CACTGTCATCCGTTCGACGC
ATAGAGGGAGAACTGAACGA -> TAGAGGGAGAACTGAACGAT
TTTTACTTGCGAAGCTAACC -> TTTACTTGCGAAGCTAACCG
CTTTTACTTGCGAAGCTAAC -> TTTTACTTGCGAAGCTAACC
TTATAGAGGGAGAACTGAAC -> TATAGAGGGAGAACTGAACG
GTTATAGAGGGAGAACTGAA -> TTATAGAGGGAGAACTGAAC
ACCGTACGCCACTCTATGGC -> CCGTACGCCACTCTATGGCT
TACCGTACGCCACTCTATGG -> ACCGTACGCCACTCTATGGC
CGAAGCTAACCGGGTTTGAT -> GAAGCTAACCGGGTTTGATG
GAAGCTAACCGGGTTTGATG -> AAGCTAACCGGGTTTGATGT
AGTGGAGTTATAGAGGGAGA -> GTGGAGTTATAGAGGGAGAA
AAGTGGAGTTATAGAGGGAG -> AGTGGAGTTATAGAGGGAGA
GAATTTCGCTGTCTGGAAGC -> AATTTCGCTGTCTGGAAGCG
AGAATTTCGCTGTCTGGAAG -> GAATTTCGCTGTCTGGAAGC
TGGCCGCATGGGCCAAAGTT -> GGCCGCATGGGCCAAAGTTA
GGCCGCATGGGCCAAAGTTA -> GCCGCATGGGCCAAAGTTAG
AGTCTACGTGTAGGACTCGC -> GTCTACGTGTAGGACTCGCT
ATCAGTTTCATGTCGTTGGA -> TCAGTTTCATGTCGTTGGAC
CATCAGTTTCATGTCGTTGG -> ATCAGTTTCATGTCGTTGGA
CGCCACTCTATGGCTATCTT -> GCCACTCTATGGCTATCTTT
ACGCCACTCTATGGCTATCT -> CGCCACTCTATGGCTATCTT
TTTCTAGACCTTTTTTTACC -> TTCTAGACCTTTTTTTACCC
TTCTAGACCTTTTTTTACCC -> TCTAGACCTTTTTTTACCCT
CTTGAGATAGACGCCGTCAA -> TTGAGATAGACGCCGTCAAG
TTGAGATAGACGCCGTCAAG -> TGAGATAGACGCCGTCAAGA
ATACAATACTCCATGCCGAT -> TACAATACTCCATGCCGATG
TACAATACTCCATGCCGATG -> ACAATACTCCATGCCGATGC
TGATGTCTTGTACGTTCCTA -> GATGTCTTGTACGTTCCTAG
TTGATGTCTTGTACGTTCCT -> TGATGTCTTGTACGTTCCTA
TGGGCCAAAGTTAGCGAGGG -> GGGCCAAAGTTAGCGAGGGC
GATAGACGCCGTCAAGATTC -> ATAGACGCCGTCAAGATTCC
AGATAGACGCCGTCAAGATT -> GATAGACGCCGTCAAGATTC
GCCAAAGTTAGCGAGGGCAT -> CCAAAGTTAGCGAGGGCATT
GGCCAAAGTTAGCGAGGGCA -> GCCAAAGTTAGCGAGGGCAT
GAGAAGTAGTAGATTCTCTA -> AGAAGTAGTAGATTCTCTAG
AGAAGTAGTAGATTCTCTAG -> GAAGTAGTAGATTCTCTAGA
ACGGGAATTGTTTCGACCTT -> CGGGAATTGTTTCGACCTTA
CACTAACAGTTTAACGTCTC -> ACTAACAGTTTAACGTCTCT
ACTAACAGTTTAACGTCTCT -> CTAACAGTTTAACGTCTCTT
AAAAACCGGGCGTCTTCGTT -> AAAACCGGGCGTCTTCGTTC
TACTTGGCCAGGCGCATCAG -> ACTTGGCCAGGCGCATCAGT
ACTTGGCCAGGCGCATCAGT -> CTTGGCCAGGCGCATCAGTT
GATTCCCGTCTAGTGGTAGC -> ATTCCCGTCTAGTGGTAGCA
ATTCCCGTCTAGTGGTAGCA -> TTCCCGTCTAGTGGTAGCAT
CACGCATGCGCAGCGTGGCC -> ACGCATGCGCAGCGTGGCCG
CAGCTATACCGTACGCCACT -> AGCTATACCGTACGCCACTC
TCTCTGTGATTATAGCGCAG -> CTCTGTGATTATAGCGCAGC
CTCTGTGATTATAGCGCAGC -> TCTGTGATTATAGCGCAGCA
GATTCTCTAGATATACGTCA -> ATTCTCTAGATATACGTCAC
AGATTCTCTAGATATACGTC -> GATTCTCTAGATATACGTCA
CGTACGCCACTCTATGGCTA -> GTACGCCACTCTATGGCTAT
CCGTACGCCACTCTATGGCT -> CGTACGCCACTCTATGGCTA
GACTCTAAGCTTAGCTCGCT -> ACTCTAAGCTTAGCTCGCTG
ACATACAGGACCATCGGGCG -> CATACAGGACCATCGGGCGT
CACATACAGGACCATCGGGC -> ACATACAGGACCATCGGGCG
CATGCAGCTATACCGTACGC -> ATGCAGCTATACCGTACGCC
ATGCAGCTATACCGTACGCC -> TGCAGCTATACCGTACGCCA
AAGCGAAAACGACCCACTGG -> AGCGAAAACGACCCACTGGT
TAAGCGAAAACGACCCACTG -> AAGCGAAAACGACCCACTGG
GGACCATCGGGCGTAAGAAT -> GACCATCGGGCGTAAGAATA
GACCATCGGGCGTAAGAATA -> ACCATCGGGCGTAAGAATAA
TGAGGCCGCGCGTAAGCCAG -> GAGGCCGCGCGTAAGCCAGT
GAGGCCGCGCGTAAGCCAGT -> AGGCCGCGCGTAAGCCAGTG
ACTGTTGGCTCTGCGATCTG -> CTGTTGGCTCTGCGATCTGT
CTGACCCCATTGCTACACCT -> TGACCCCATTGCTACACCTG
GCTGACCCCATTGCTACACC -> CTGACCCCATTGCTACACCT
GTGAGGCCGCGCGTAAGCCA -> TGAGGCCGCGCGTAAGCCAG
GGTGAGGCCGCGCGTAAGCC -> GTGAGGCCGCGCGTAAGCCA
ATTCTCTAGATATACGTCAC -> TTCTCTAGATATACGTCACC
CCTCCGAGATATCAAGACTC -> CTCCGAGATATCAAGACTCA
TTCATGTCGTTGGACATCAA -> TCATGTCGTTGGACATCAAT
TCATGTCGTTGGACATCAAT -> CATGTCGTTGGACATCAATA
GCGCGTAAGCCAGTGCACCA -> CGCGTAAGCCAGTGCACCAT
CGCGTAAGCCAGTGCACCAT -> GCGTAAGCCAGTGCACCATA
TACTTGCGAAGCTAACCGGG -> ACTTGCGAAGCTAACCGGGT
ACTTGCGAAGCTAACCGGGT -> CTTGCGAAGCTAACCGGGTT
TACCCTCCGAGATATCAAGA -> ACCCTCCGAGATATCAAGAC
TTACCCTCCGAGATATCAAG -> TACCCTCCGAGATATCAAGA
TCTGGAGAAGTAGTAGATTC -> CTGGAGAAGTAGTAGATTCT
GATCTCTGTGATTATAGCGC -> ATCTCTGTGATTATAGCGCA
ATCTCTGTGATTATAGCGCA -> TCTCTGTGATTATAGCGCAG
TCTCTTGAGATAGACGCCGT -> CTCTTGAGATAGACGCCGTC
GTCTCTTGAGATAGACGCCG -> TCTCTTGAGATAGACGCCGT
CTATCACGGATGTGTCAAAG -> TATCACGGATGTGTCAAAGA
TATCACGGATGTGTCAAAGA -> ATCACGGATGTGTCAAAGAT
GACGCCGTCAAGATTCCCGT -> ACGCCGTCAAGATTCCCGTC
ACGCCGTCAAGATTCCCGTC -> CGCCGTCAAGATTCCCGTCT
ACATAGCAGAGCCGGGTTTT -> CATAGCAGAGCCGGGTTTTT
TACATAGCAGAGCCGGGTTT -> ACATAGCAGAGCCGGGTTTT
AGAGTTCTTCACGTCGCACT -> GAGTTCTTCACGTCGCACTG
GAGTTCTTCACGTCGCACTG -> AGTTCTTCACGTCGCACTGT
GACTATCACGGATGTGTCAA -> ACTATCACGGATGTGTCAAA
CGACTATCACGGATGTGTCA -> GACTATCACGGATGTGTCAA
GTGGTTCTTGTAAAAGTATT -> TGGTTCTTGTAAAAGTATTC
TGGTTCTTGTAAAAGTATTC -> GGTTCTTGTAAAAGTATTCT
GTGGAGTTATAGAGGGAGAA -> TGGAGTTATAGAGGGAGAAC
TGGAGTTATAGAGGGAGAAC -> GGAGTTATAGAGGGAGAACT
CAACACTAACAGTTTAACGT -> AACACTAACAGTTTAACGTC
ACGATCGCATAGAAGGGAAG -> CGATCGCATAGAAGGGAAGT
CGATCGCATAGAAGGGAAGT -> GATCGCATAGAAGGGAAGTA
CCCATTGCTACACCTGTGGG -> CCATTGCTACACCTGTGGGC
CCATTGCTACACCTGTGGGC -> CATTGCTACACCTGTGGGCG
ATTCTCAGACCGAGCTGGGG -> TTCTCAGACCGAGCTGGGGT
TTCTCAGACCGAGCTGGGGT -> TCTCAGACCGAGCTGGGGTT
CGTCGCACTGTCTCATCATC -> GTCGCACTGTCTCATCATCA
ACGTCGCACTGTCTCATCAT -> CGTCGCACTGTCTCATCATC
ATAGCAGAGCCGGGTTTTTG -> TAGCAGAGCCGGGTTTTTGG
TAGCAGAGCCGGGTTTTTGG -> AGCAGAGCCGGGTTTTTGGA
GAGAACTGAACGATCGCATA -> AGAACTGAACGATCGCATAG
ATACTCCATGCCGATGCAGA -> TACTCCATGCCGATGCAGAA
AATACTCCATGCCGATGCAG -> ATACTCCATGCCGATGCAGA
CAAGAAAAACCGGGCGTCTT -> AAGAAAAACCGGGCGTCTTC
CCAAGAAAAACCGGGCGTCT -> CAAGAAAAACCGGGCGTCTT
TGCCACTGTCATCCGTTCGA -> GCCACTGTCATCCGTTCGAC
CAGAATTTCGCTGTCTGGAA -> AGAATTTCGCTGTCTGGAAG
GTAGTAGATTCTCTAGATAT -> TAGTAGATTCTCTAGATATA
TAGTAGATTCTCTAGATATA -> AGTAGATTCTCTAGATATAC
GTCATCCGTTCGACGCGTCT -> TCATCCGTTCGACGCGTCTA
TGTCATCCGTTCGACGCGTC -> GTCATCCGTTCGACGCGTCT
TGGGGTTTAAGTGGAGTTAT -> GGGGTTTAAGTGGAGTTATA
TCGCACTGTCTCATCATCAC -> CGCACTGTCTCATCATCACA
CGCACTGTCTCATCATCACA -> GCACTGTCTCATCATCACAG
ACTATCACGGATGTGTCAAA -> CTATCACGGATGTGTCAAAG
TCGTTGGACATCAATATTAC -> CGTTGGACATCAATATTACC
GTCGTTGGACATCAATATTA -> TCGTTGGACATCAATATTAC
CGTCTCTTGAGATAGACGCC -> GTCTCTTGAGATAGACGCCG
TCTTGAGATAGACGCCGTCA -> CTTGAGATAGACGCCGTCAA
ACTGGTGCTTGTACTTGGCC -> CTGGTGCTTGTACTTGGCCA
CTGGTGCTTGTACTTGGCCA -> TGGTGCTTGTACTTGGCCAG
TTTCGCTGTCTGGAAGCGTA -> TTCGCTGTCTGGAAGCGTAA
TTCGCTGTCTGGAAGCGTAA -> TCGCTGTCTGGAAGCGTAAA
TGTGGGGACACCACCCGTTT -> GTGGGGACACCACCCGTTTT
GTGGGGACACCACCCGTTTT -> TGGGGACACCACCCGTTTTG
TAAGCCAGTGCACCATACAA -> AAGCCAGTGCACCATACAAT
GTAAGCCAGTGCACCATACA -> TAAGCCAGTGCACCATACAA
TCAGTCGCACATACAGGACC -> CAGTCGCACATACAGGACCA
CAGTCGCACATACAGGACCA -> AGTCGCACATACAGGACCAT
CTTATAGCTTACAAACCAAG -> TTATAGCTTACAAACCAAGT
CCTTATAGCTTACAAACCAA -> CTTATAGCTTACAAACCAAG
TACGTTCCTAGTGGGAATCC -> ACGTTCCTAGTGGGAATCCA
ACGTTCCTAGTGGGAATCCA -> CGTTCCTAGTGGGAATCCAG
CTTGTACTTGGCCAGGCGCA -> TTGTACTTGGCCAGGCGCAT
TTGTACTTGGCCAGGCGCAT -> TGTACTTGGCCAGGCGCATC
GGATGTGTCAAAGATATATA -> GATGTGTCAAAGATATATAG
GATGTGTCAAAGATATATAG -> ATGTGTCAAAGATATATAGA
CTACGTGTAGGACTCGCTGT -> TACGTGTAGGACTCGCTGTA
ACCGGGCGTCTTCGTTCATT -> CCGGGCGTCTTCGTTCATTT
CCGGGCGTCTTCGTTCATTT -> CGGGCGTCTTCGTTCATTTT
CTGTGGGGACACCACCCGTT -> TGTGGGGACACCACCCGTTT
TTTACTTGCGAAGCTAACCG -> TTACTTGCGAAGCTAACCGG
TTAGCTCGCTGACCCCATTG -> TAGCTCGCTGACCCCATTGC
CTTAGCTCGCTGACCCCATT -> TTAGCTCGCTGACCCCATTG
AGGTGAGGCCGCGCGTAAGC -> GGTGAGGCCGCGCGTAAGCC
TAGGTGAGGCCGCGCGTAAG -> AGGTGAGGCCGCGCGTAAGC
CGCGCGTAAGCCAGTGCACC -> GCGCGTAAGCCAGTGCACCA
CCGCGCGTAAGCCAGTGCAC -> CGCGCGTAAGCCAGTGCACC
GGGCCAAAGTTAGCGAGGGC -> GGCCAAAGTTAGCGAGGGCA
TGTCTGGAAGCGTAAACCAA -> GTCTGGAAGCGTAAACCAAG
CTGTCTGGAAGCGTAAACCA -> TGTCTGGAAGCGTAAACCAA
ATTGCTACACCTGTGGGCGC -> TTGCTACACCTGTGGGCGCA
CATTGCTACACCTGTGGGCG -> ATTGCTACACCTGTGGGCGC
GATATACGTCACCGCCACGC -> ATATACGTCACCGCCACGCA
AGATATACGTCACCGCCACG -> GATATACGTCACCGCCACGC
CTAAGCTTAGCTCGCTGACC -> TAAGCTTAGCTCGCTGACCC
TAAGCTTAGCTCGCTGACCC -> AAGCTTAGCTCGCTGACCCC
CTTACAAACCAAGTGTACGT -> TTACAAACCAAGTGTACGTC
TTACAAACCAAGTGTACGTC -> TACAAACCAAGTGTACGTCT
GTAATTTACAGTCCGTGGTT -> TAATTTACAGTCCGTGGTTC
TAATTTACAGTCCGTGGTTC -> AATTTACAGTCCGTGGTTCT
TTTTGGACGCGCCATGCAGC -> TTTGGACGCGCCATGCAGCT
TTTTTGGACGCGCCATGCAG -> TTTTGGACGCGCCATGCAGC
CGAGCTGGGGTTTAAGTGGA -> GAGCTGGGGTTTAAGTGGAG
CCGAGCTGGGGTTTAAGTGG -> CGAGCTGGGGTTTAAGTGGA
CGTCTAGCTGCGATCTCTGT -> GTCTAGCTGCGATCTCTGTG
GTCTAGCTGCGATCTCTGTG -> TCTAGCTGCGATCTCTGTGA
AAAACCGGGCGTCTTCGTTC -> AAACCGGGCGTCTTCGTTCA
CGTTCGACGCGTCTACCGGG -> GTTCGACGCGTCTACCGGGC
CCGTTCGACGCGTCTACCGG -> CGTTCGACGCGTCTACCGGG
CCTTTTTTTACCCTCCGAGA -> CTTTTTTTACCCTCCGAGAT
CTTTTTTTACCCTCCGAGAT -> TTTTTTTACCCTCCGAGATA
ATCTTTTACTTGCGAAGCTA -> TCTTTTACTTGCGAAGCTAA
TCTTTTACTTGCGAAGCTAA -> CTTTTACTTGCGAAGCTAAC
CGATCTGTGGGGACACCACC -> GATCTGTGGGGACACCACCC
GATCTGTGGGGACACCACCC -> ATCTGTGGGGACACCACCCG
CTACACCTGTGGGCGCATCT -> TACACCTGTGGGCGCATCTC
TACACCTGTGGGCGCATCTC -> ACACCTGTGGGCGCATCTCG
GCGAAGCTAACCGGGTTTGA -> CGAAGCTAACCGGGTTTGAT
TGCGAAGCTAACCGGGTTTG -> GCGAAGCTAACCGGGTTTGA
CTGCCACTGTCATCCGTTCG -> TGCCACTGTCATCCGTTCGA
GCTGCCACTGTCATCCGTTC -> CTGCCACTGTCATCCGTTCG
ACAATACTCCATGCCGATGC -> CAATACTCCATGCCGATGCA
CAATACTCCATGCCGATGCA -> AATACTCCATGCCGATGCAG
CTTCACGTCGCACTGTCTCA -> TTCACGTCGCACTGTCTCAT
TTCACGTCGCACTGTCTCAT -> TCACGTCGCACTGTCTCATC
TCATTTTAGTGACGGGAATT -> CATTTTAGTGACGGGAATTG
TTCATTTTAGTGACGGGAAT -> TCATTTTAGTGACGGGAATT
TATTCTCAGACCGAGCTGGG -> ATTCTCAGACCGAGCTGGGG
CATAGCAGAGCCGGGTTTTT -> ATAGCAGAGCCGGGTTTTTG
TTCCCGTCTAGTGGTAGCAT -> TCCCGTCTAGTGGTAGCATA
TCCCGTCTAGTGGTAGCATA -> CCCGTCTAGTGGTAGCATAG
TTTGGACGCGCCATGCAGCT -> TTGGACGCGCCATGCAGCTA
CGCGTCTACCGGGCAACTGT -> GCGTCTACCGGGCAACTGTT
ACGCGTCTACCGGGCAACTG -> CGCGTCTACCGGGCAACTGT
CATCAATATTACCCCTTAGA -> ATCAATATTACCCCTTAGAG
ACATCAATATTACCCCTTAG -> CATCAATATTACCCCTTAGA
GTCTTGTACGTTCCTAGTGG -> TCTTGTACGTTCCTAGTGGG
TCTTGTACGTTCCTAGTGGG -> CTTGTACGTTCCTAGTGGGA
CGAAAACGACCCACTGGTGC -> GAAAACGACCCACTGGTGCT
GAAAACGACCCACTGGTGCT -> AAAACGACCCACTGGTGCTT
TCTGTGGGGACACCACCCGT -> CTGTGGGGACACCACCCGTT
GTCAGTCGCACATACAGGAC -> TCAGTCGCACATACAGGACC
TCGCTGACCCCATTGCTACA -> CGCTGACCCCATTGCTACAC
CGCTGACCCCATTGCTACAC -> GCTGACCCCATTGCTACACC
TCGGGCGTAAGAATAAGTCT -> CGGGCGTAAGAATAAGTCTA
CGGGCGTAAGAATAAGTCTA -> GGGCGTAAGAATAAGTCTAC
TATACCGTACGCCACTCTAT -> ATACCGTACGCCACTCTATG
ATACCGTACGCCACTCTATG -> TACCGTACGCCACTCTATGG
TGAGATAGACGCCGTCAAGA -> GAGATAGACGCCGTCAAGAT
GCTGGGGTTTAAGTGGAGTT -> CTGGGGTTTAAGTGGAGTTA
AGCTGGGGTTTAAGTGGAGT -> GCTGGGGTTTAAGTGGAGTT
AGACGCCGTCAAGATTCCCG -> GACGCCGTCAAGATTCCCGT
TAGACGCCGTCAAGATTCCC -> AGACGCCGTCAAGATTCCCG
TCCAGCGACTATCACGGATG -> CCAGCGACTATCACGGATGT
ATCCAGCGACTATCACGGAT -> TCCAGCGACTATCACGGATG
CCAGCGACTATCACGGATGT -> CAGCGACTATCACGGATGTG
GACCCCATTGCTACACCTGT -> ACCCCATTGCTACACCTGTG
TGACCCCATTGCTACACCTG -> GACCCCATTGCTACACCTGT
TCCGTTCGACGCGTCTACCG -> CCGTTCGACGCGTCTACCGG
ATCCGTTCGACGCGTCTACC -> TCCGTTCGACGCGTCTACCG
AATATTACCCCTTAGAGTTC -> ATATTACCCCTTAGAGTTCT
CAATATTACCCCTTAGAGTT -> AATATTACCCCTTAGAGTTC
GGTTTGATGTCTTGTACGTT -> GTTTGATGTCTTGTACGTTC
GTTTGATGTCTTGTACGTTC -> TTTGATGTCTTGTACGTTCC
CCGTCTAGCTGCGATCTCTG -> CGTCTAGCTGCGATCTCTGT
CGTTGGACATCAATATTACC -> GTTGGACATCAATATTACCC
GATTATAGCGCAGCAAACTG -> ATTATAGCGCAGCAAACTGC
TGATTATAGCGCAGCAAACT -> GATTATAGCGCAGCAAACTG
TAGTGACGGGAATTGTTTCG -> AGTGACGGGAATTGTTTCGA
TTAGTGACGGGAATTGTTTC -> TAGTGACGGGAATTGTTTCG
ATATTACCCCTTAGAGTTCT -> TATTACCCCTTAGAGTTCTT
TCTTCACGTCGCACTGTCTC -> CTTCACGTCGCACTGTCTCA
TGTAATTTACAGTCCGTGGT -> GTAATTTACAGTCCGTGGTT
ACCATCGGGCGTAAGAATAA -> CCATCGGGCGTAAGAATAAG
CCATCGGGCGTAAGAATAAG -> CATCGGGCGTAAGAATAAGT
ATGTCTTGTACGTTCCTAGT -> TGTCTTGTACGTTCCTAGTG
GATGTCTTGTACGTTCCTAG -> ATGTCTTGTACGTTCCTAGT
CGCAGCAAACTGCTACATAG -> GCAGCAAACTGCTACATAGC
AGGGCATTACAAACGTACAA -> GGGCATTACAAACGTACAAA
ATAGACGCCGTCAAGATTCC -> TAGACGCCGTCAAGATTCCC
CACTGTCTCATCATCACAGG -> ACTGTCTCATCATCACAGGC
ACTGTCTCATCATCACAGGC -> CTGTCTCATCATCACAGGCT
ACAAACCAAGTGTACGTCTT -> CAAACCAAGTGTACGTCTTT
TACAAACCAAGTGTACGTCT -> ACAAACCAAGTGTACGTCTT
TAGCTGCGATCTCTGTGATT -> AGCTGCGATCTCTGTGATTA
AAACGACCCACTGGTGCTTG -> AACGACCCACTGGTGCTTGT
AACGACCCACTGGTGCTTGT -> ACGACCCACTGGTGCTTGTA
ATCTGTGGGGACACCACCCG -> TCTGTGGGGACACCACCCGT
CGGGTTTGATGTCTTGTACG -> GGGTTTGATGTCTTGTACGT
GGGTTTGATGTCTTGTACGT -> GGTTTGATGTCTTGTACGTT
TTTTGGACCGTCTAGCTGCG -> TTTGGACCGTCTAGCTGCGA
AATTTACAGTCCGTGGTTCT -> ATTTACAGTCCGTGGTTCTT
CCCCATTGCTACACCTGTGG -> CCCATTGCTACACCTGTGGG
CGGATGTGTCAAAGATATAT -> GGATGTGTCAAAGATATATA
ACGGATGTGTCAAAGATATA -> CGGATGTGTCAAAGATATAT
GAGCTGGGGTTTAAGTGGAG -> AGCTGGGGTTTAAGTGGAGT
TCTGTGATTATAGCGCAGCA -> CTGTGATTATAGCGCAGCAA
CTGTGATTATAGCGCAGCAA -> TGTGATTATAGCGCAGCAAA
GGCGTCTTCGTTCATTTTAG -> GCGTCTTCGTTCATTTTAGT
GCGTCTTCGTTCATTTTAGT -> CGTCTTCGTTCATTTTAGTG
ACCTTTTTTTACCCTCCGAG -> CCTTTTTTTACCCTCCGAGA
AACTGAACGATCGCATAGAA -> ACTGAACGATCGCATAGAAG
GATGCAGAATTTCGCTGTCT -> ATGCAGAATTTCGCTGTCTG
ATGCAGAATTTCGCTGTCTG -> TGCAGAATTTCGCTGTCTGG
TAGCTCGCTGACCCCATTGC -> AGCTCGCTGACCCCATTGCT
ACTGAACGATCGCATAGAAG -> CTGAACGATCGCATAGAAGG
CTGAACGATCGCATAGAAGG -> TGAACGATCGCATAGAAGGG
GGCGCATCTCGACAATACAT -> GCGCATCTCGACAATACATC
GGGCGCATCTCGACAATACA -> GGCGCATCTCGACAATACAT
CAGGCTGCCACTGTCATCCG -> AGGCTGCCACTGTCATCCGT
AGGCTGCCACTGTCATCCGT -> GGCTGCCACTGTCATCCGTT
CAAGACTCAACACTAACAGT -> AAGACTCAACACTAACAGTT
AAAGTATTCTCAGACCGAGC -> AAGTATTCTCAGACCGAGCT
AAGTATTCTCAGACCGAGCT -> AGTATTCTCAGACCGAGCTG
GTAAAAGTATTCTCAGACCG -> TAAAAGTATTCTCAGACCGA
TGTAAAAGTATTCTCAGACC -> GTAAAAGTATTCTCAGACCG
TATCTTTTACTTGCGAAGCT -> ATCTTTTACTTGCGAAGCTA
TTTAAGCGAAAACGACCCAC -> TTAAGCGAAAACGACCCACT
TTAAGCGAAAACGACCCACT -> TAAGCGAAAACGACCCACTG
GCGTAAGCCAGTGCACCATA -> CGTAAGCCAGTGCACCATAC
CGTAAGCCAGTGCACCATAC -> GTAAGCCAGTGCACCATACA
CTAGATATACGTCACCGCCA -> TAGATATACGTCACCGCCAC
TCTAGATATACGTCACCGCC -> CTAGATATACGTCACCGCCA
GACCCACTGGTGCTTGTACT -> ACCCACTGGTGCTTGTACTT
CGACCCACTGGTGCTTGTAC -> GACCCACTGGTGCTTGTACT
TCTAGTGGTAGCATAGATGG -> CTAGTGGTAGCATAGATGGG
CTAGTGGTAGCATAGATGGG -> TAGTGGTAGCATAGATGGGT
GGACTCGCTGTAATTTACAG -> GACTCGCTGTAATTTACAGT
CCATGCAGCTATACCGTACG -> CATGCAGCTATACCGTACGC
GCCATGCAGCTATACCGTAC -> CCATGCAGCTATACCGTACG
AACGTACAAAGTCAGTCGCA -> ACGTACAAAGTCAGTCGCAC
ACGTACAAAGTCAGTCGCAC -> CGTACAAAGTCAGTCGCACA
CTGGGGTTTAAGTGGAGTTA -> TGGGGTTTAAGTGGAGTTAT
GAAGGGAAGTATTCCTTTCG -> AAGGGAAGTATTCCTTTCGA
ATTCCTTTCGATAGGTGAGG -> TTCCTTTCGATAGGTGAGGC
TATTCCTTTCGATAGGTGAG -> ATTCCTTTCGATAGGTGAGG
TTAAGTGGAGTTATAGAGGG -> TAAGTGGAGTTATAGAGGGA
TAAGTGGAGTTATAGAGGGA -> AAGTGGAGTTATAGAGGGAG
GTCGCACTGTCTCATCATCA -> TCGCACTGTCTCATCATCAC
GAACGATCGCATAGAAGGGA -> AACGATCGCATAGAAGGGAA
TGAACGATCGCATAGAAGGG -> GAACGATCGCATAGAAGGGA
CTAACCGGGTTTGATGTCTT -> TAACCGGGTTTGATGTCTTG
GCTAACCGGGTTTGATGTCT -> CTAACCGGGTTTGATGTCTT
TCCATGCCGATGCAGAATTT -> CCATGCCGATGCAGAATTTC
CCATGCCGATGCAGAATTTC -> CATGCCGATGCAGAATTTCG
TCATCCGTTCGACGCGTCTA -> CATCCGTTCGACGCGTCTAC
TAAAAGTATTCTCAGACCGA -> AAAAGTATTCTCAGACCGAG
TGTACGTCTTTCTAGACCTT -> GTACGTCTTTCTAGACCTTT
AGCGAAAACGACCCACTGGT -> GCGAAAACGACCCACTGGTG
TTCCTTTCGATAGGTGAGGC -> TCCTTTCGATAGGTGAGGCC
GCGAAAACGACCCACTGGTG -> CGAAAACGACCCACTGGTGC
GTTTCATGTCGTTGGACATC -> TTTCATGTCGTTGGACATCA
AGTTTCATGTCGTTGGACAT -> GTTTCATGTCGTTGGACATC
CTGGAGAAGTAGTAGATTCT -> TGGAGAAGTAGTAGATTCTC
TGGAGAAGTAGTAGATTCTC -> GGAGAAGTAGTAGATTCTCT
CAACTGTTGGCTCTGCGATC -> AACTGTTGGCTCTGCGATCT
GCAACTGTTGGCTCTGCGAT -> CAACTGTTGGCTCTGCGATC
CGATCTCTGTGATTATAGCG -> GATCTCTGTGATTATAGCGC
CTCGACAATACATCACACGC -> TCGACAATACATCACACGCA
TCGACAATACATCACACGCA -> CGACAATACATCACACGCAA
CTACCGGGCAACTGTTGGCT -> TACCGGGCAACTGTTGGCTC
TCTACCGGGCAACTGTTGGC -> CTACCGGGCAACTGTTGGCT
ACTGTCATCCGTTCGACGCG -> CTGTCATCCGTTCGACGCGT
CACTGTCATCCGTTCGACGC -> ACTGTCATCCGTTCGACGCG
GCCGCATGGGCCAAAGTTAG -> CCGCATGGGCCAAAGTTAGC
GAGATAGACGCCGTCAAGAT -> AGATAGACGCCGTCAAGATT
CCCCTTAGAGTTCTTCACGT -> CCCTTAGAGTTCTTCACGTC
CGGGCAACTGTTGGCTCTGC -> GGGCAACTGTTGGCTCTGCG
TATAGAGGGAGAACTGAACG -> ATAGAGGGAGAACTGAACGA
TCTCAGACCGAGCTGGGGTT -> CTCAGACCGAGCTGGGGTTT
AGTAGTAGATTCTCTAGATA -> GTAGTAGATTCTCTAGATAT
GTACGTCTTTCTAGACCTTT -> TACGTCTTTCTAGACCTTTT
TACGTCTTTCTAGACCTTTT -> ACGTCTTTCTAGACCTTTTT
AGGACTCGCTGTAATTTACA -> GGACTCGCTGTAATTTACAG
TCCGTGGTTCTTGTAAAAGT -> CCGTGGTTCTTGTAAAAGTA
CCGTGGTTCTTGTAAAAGTA -> CGTGGTTCTTGTAAAAGTAT
AAGTAGTAGATTCTCTAGAT -> AGTAGTAGATTCTCTAGATA
CTCCATGCCGATGCAGAATT -> TCCATGCCGATGCAGAATTT
GTTCCTAGTGGGAATCCAGC -> TTCCTAGTGGGAATCCAGCG
CGTTCCTAGTGGGAATCCAG -> GTTCCTAGTGGGAATCCAGC
ATATCAAGACTCAACACTAA -> TATCAAGACTCAACACTAAC
TATCAAGACTCAACACTAAC -> ATCAAGACTCAACACTAACA
TACGTCACCGCCACGCATGC -> ACGTCACCGCCACGCATGCG
ACGTCACCGCCACGCATGCG -> CGTCACCGCCACGCATGCGC
GGACCGTCTAGCTGCGATCT -> GACCGTCTAGCTGCGATCTC
TGGACCGTCTAGCTGCGATC -> GGACCGTCTAGCTGCGATCT
GATAGGTGAGGCCGCGCGTA -> ATAGGTGAGGCCGCGCGTAA
ATAGGTGAGGCCGCGCGTAA -> TAGGTGAGGCCGCGCGTAAG
GGAGAAGTAGTAGATTCTCT -> GAGAAGTAGTAGATTCTCTA
CACCACCCGTTTTGGACCGT -> ACCACCCGTTTTGGACCGTC
ACACCACCCGTTTTGGACCG -> CACCACCCGTTTTGGACCGT
GCATGCGCAGCGTGGCCGCA -> CATGCGCAGCGTGGCCGCAT
CGCATGCGCAGCGTGGCCGC -> GCATGCGCAGCGTGGCCGCA
TTAACGTCTCTTGAGATAGA -> TAACGTCTCTTGAGATAGAC
TAACGTCTCTTGAGATAGAC -> AACGTCTCTTGAGATAGACG
GCGCCATGCAGCTATACCGT -> CGCCATGCAGCTATACCGTA
CGCCATGCAGCTATACCGTA -> GCCATGCAGCTATACCGTAC
TACTCCATGCCGATGCAGAA -> ACTCCATGCCGATGCAGAAT
ACTCCATGCCGATGCAGAAT -> CTCCATGCCGATGCAGAATT
GATCGCATAGAAGGGAAGTA -> ATCGCATAGAAGGGAAGTAT
CTCGCTGACCCCATTGCTAC -> TCGCTGACCCCATTGCTACA
CGTAAACCAAGAAAAACCGG -> GTAAACCAAGAAAAACCGGG
AGTAGATTCTCTAGATATAC -> GTAGATTCTCTAGATATACG
GTAGATTCTCTAGATATACG -> TAGATTCTCTAGATATACGT
AACAGTTTAACGTCTCTTGA -> ACAGTTTAACGTCTCTTGAG
TAACAGTTTAACGTCTCTTG -> AACAGTTTAACGTCTCTTGA
CATGCCGATGCAGAATTTCG -> ATGCCGATGCAGAATTTCGC
CTCGCTGTAATTTACAGTCC -> TCGCTGTAATTTACAGTCCG
TCGCTGTAATTTACAGTCCG -> CGCTGTAATTTACAGTCCGT
TCGATAGGTGAGGCCGCGCG -> CGATAGGTGAGGCCGCGCGT
CTTTCTAGACCTTTTTTTAC -> TTTCTAGACCTTTTTTTACC
CCGTTTTGGACCGTCTAGCT -> CGTTTTGGACCGTCTAGCTG
CAAAGTCAGTCGCACATACA -> AAAGTCAGTCGCACATACAG
TCAGTTTCATGTCGTTGGAC -> CAGTTTCATGTCGTTGGACA
CAAACCAAGTGTACGTCTTT -> AAACCAAGTGTACGTCTTTC
GTATTCTCAGACCGAGCTGG -> TATTCTCAGACCGAGCTGGG
AGTATTCTCAGACCGAGCTG -> GTATTCTCAGACCGAGCTGG
CAGCGACTATCACGGATGTG -> AGCGACTATCACGGATGTGT
AGCGACTATCACGGATGTGT -> GCGACTATCACGGATGTGTC
GACCGAGCTGGGGTTTAAGT -> ACCGAGCTGGGGTTTAAGTG
ACCGAGCTGGGGTTTAAGTG -> CCGAGCTGGGGTTTAAGTGG
GACCGTCTAGCTGCGATCTC -> ACCGTCTAGCTGCGATCTCT
ACGCATGCGCAGCGTGGCCG -> CGCATGCGCAGCGTGGCCGC
ACAGGCTGCCACTGTCATCC -> CAGGCTGCCACTGTCATCCG
CTGGAAGCGTAAACCAAGAA -> TGGAAGCGTAAACCAAGAAA
GATATATAGACTCTAAGCTT -> ATATATAGACTCTAAGCTTA
ATATATAGACTCTAAGCTTA -> TATATAGACTCTAAGCTTAG
CGTGTAGGACTCGCTGTAAT -> GTGTAGGACTCGCTGTAATT
ACGTGTAGGACTCGCTGTAA -> CGTGTAGGACTCGCTGTAAT
CACAGGCTGCCACTGTCATC -> ACAGGCTGCCACTGTCATCC
TCACAGGCTGCCACTGTCAT -> CACAGGCTGCCACTGTCATC
GACATCAATATTACCCCTTA -> ACATCAATATTACCCCTTAG
CCCGTTTTGGACCGTCTAGC -> CCGTTTTGGACCGTCTAGCT
ACCCGTTTTGGACCGTCTAG -> CCCGTTTTGGACCGTCTAGC
ATGCGCAGCGTGGCCGCATG -> TGCGCAGCGTGGCCGCATGG
ATCACGGATGTGTCAAAGAT -> TCACGGATGTGTCAAAGATA
CTAGACCTTTTTTTACCCTC -> TAGACCTTTTTTTACCCTCC
TAGACCTTTTTTTACCCTCC -> AGACCTTTTTTTACCCTCCG
TTACAGTCCGTGGTTCTTGT -> TACAGTCCGTGGTTCTTGTA
TACAGTCCGTGGTTCTTGTA -> ACAGTCCGTGGTTCTTGTAA
CGTAAGAATAAGTCTACGTG -> GTAAGAATAAGTCTACGTGT
GTAAGAATAAGTCTACGTGT -> TAAGAATAAGTCTACGTGTA
GCTTGTACTTGGCCAGGCGC -> CTTGTACTTGGCCAGGCGCA
ATTATAGCGCAGCAAACTGC -> TTATAGCGCAGCAAACTGCT
AGGACCATCGGGCGTAAGAA -> GGACCATCGGGCGTAAGAAT
ACACCTGTGGGCGCATCTCG -> CACCTGTGGGCGCATCTCGA
GCGAGGGCATTACAAACGTA -> CGAGGGCATTACAAACGTAC
TTCGTTCATTTTAGTGACGG -> TCGTTCATTTTAGTGACGGG
TCGTTCATTTTAGTGACGGG -> CGTTCATTTTAGTGACGGGA
GCATAGATGGGTCCGCTTTA -> CATAGATGGGTCCGCTTTAA
TAGCGCAGCAAACTGCTACA -> AGCGCAGCAAACTGCTACAT
AAAGATATATAGACTCTAAG -> AAGATATATAGACTCTAAGC
CAAAGATATATAGACTCTAA -> AAAGATATATAGACTCTAAG
GCTTAGCTCGCTGACCCCAT -> CTTAGCTCGCTGACCCCATT
AGCTTAGCTCGCTGACCCCA -> GCTTAGCTCGCTGACCCCAT
CCAAAGTTAGCGAGGGCATT -> CAAAGTTAGCGAGGGCATTA
CTCAGACCGAGCTGGGGTTT -> TCAGACCGAGCTGGGGTTTA
TCAGACCGAGCTGGGGTTTA -> CAGACCGAGCTGGGGTTTAA
TGTCTTGTACGTTCCTAGTG -> GTCTTGTACGTTCCTAGTGG
TTATAGCGCAGCAAACTGCT -> TATAGCGCAGCAAACTGCTA
TCGACCTTATAGCTTACAAA -> CGACCTTATAGCTTACAAAC
AAGAAAAACCGGGCGTCTTC -> AGAAAAACCGGGCGTCTTCG
GGGAGAACTGAACGATCGCA -> GGAGAACTGAACGATCGCAT
CGGGTTTTTGGACGCGCCAT -> GGGTTTTTGGACGCGCCATG
CCGGGTTTTTGGACGCGCCA -> CGGGTTTTTGGACGCGCCAT
TGTGATTATAGCGCAGCAAA -> GTGATTATAGCGCAGCAAAC
GTGATTATAGCGCAGCAAAC -> TGATTATAGCGCAGCAAACT
GGAAGCGTAAACCAAGAAAA -> GAAGCGTAAACCAAGAAAAA
TGGAAGCGTAAACCAAGAAA -> GGAAGCGTAAACCAAGAAAA
CGATAGGTGAGGCCGCGCGT -> GATAGGTGAGGCCGCGCGTA
TAGAAGGGAAGTATTCCTTT -> AGAAGGGAAGTATTCCTTTC
ATAGAAGGGAAGTATTCCTT -> TAGAAGGGAAGTATTCCTTT
GTGCTTGTACTTGGCCAGGC -> TGCTTGTACTTGGCCAGGCG
TGCTTGTACTTGGCCAGGCG -> GCTTGTACTTGGCCAGGCGC
GTTGGCTCTGCGATCTGTGG -> TTGGCTCTGCGATCTGTGGG
AACGATCGCATAGAAGGGAA -> ACGATCGCATAGAAGGGAAG
GGTTCTTGTAAAAGTATTCT -> GTTCTTGTAAAAGTATTCTC
CAGTCCGTGGTTCTTGTAAA -> AGTCCGTGGTTCTTGTAAAA
ACAGTCCGTGGTTCTTGTAA -> CAGTCCGTGGTTCTTGTAAA
ATCAAGACTCAACACTAACA -> TCAAGACTCAACACTAACAG
TCAAGACTCAACACTAACAG -> CAAGACTCAACACTAACAGT
GAAGCGTAAACCAAGAAAAA -> AAGCGTAAACCAAGAAAAAC
AAGCGTAAACCAAGAAAAAC -> AGCGTAAACCAAGAAAAACC
CCTGTGGGCGCATCTCGACA -> CTGTGGGCGCATCTCGACAA
GACGCGCCATGCAGCTATAC -> ACGCGCCATGCAGCTATACC
GTACGCCACTCTATGGCTAT -> TACGCCACTCTATGGCTATC
CCCTTAGAGTTCTTCACGTC -> CCTTAGAGTTCTTCACGTCG
AGCTAACCGGGTTTGATGTC -> GCTAACCGGGTTTGATGTCT
AAGCTAACCGGGTTTGATGT -> AGCTAACCGGGTTTGATGTC
TCATCACAGGCTGCCACTGT -> CATCACAGGCTGCCACTGTC
GGCAACTGTTGGCTCTGCGA -> GCAACTGTTGGCTCTGCGAT
GGGCAACTGTTGGCTCTGCG -> GGCAACTGTTGGCTCTGCGA
TAACCGGGTTTGATGTCTTG -> AACCGGGTTTGATGTCTTGT
ATTTCGCTGTCTGGAAGCGT -> TTTCGCTGTCTGGAAGCGTA
CTCTTGAGATAGACGCCGTC -> TCTTGAGATAGACGCCGTCA
TGTCGTTGGACATCAATATT -> GTCGTTGGACATCAATATTA
AACTGTTGGCTCTGCGATCT -> ACTGTTGGCTCTGCGATCTG
GGGCGTCTTCGTTCATTTTA -> GGCGTCTTCGTTCATTTTAG
ATCATCACAGGCTGCCACTG -> TCATCACAGGCTGCCACTGT
AGAGCCGGGTTTTTGGACGC -> GAGCCGGGTTTTTGGACGCG
CAGAGCCGGGTTTTTGGACG -> AGAGCCGGGTTTTTGGACGC
AGAAGGGAAGTATTCCTTTC -> GAAGGGAAGTATTCCTTTCG
AAGTGTACGTCTTTCTAGAC -> AGTGTACGTCTTTCTAGACC
CATACAGGACCATCGGGCGT -> ATACAGGACCATCGGGCGTA
ATACAGGACCATCGGGCGTA -> TACAGGACCATCGGGCGTAA
CCGGGTTTGATGTCTTGTAC -> CGGGTTTGATGTCTTGTACG
ACCGGGTTTGATGTCTTGTA -> CCGGGTTTGATGTCTTGTAC
AAGATATATAGACTCTAAGC -> AGATATATAGACTCTAAGCT
CGACCTTATAGCTTACAAAC -> GACCTTATAGCTTACAAACC
TTTAGTGACGGGAATTGTTT -> TTAGTGACGGGAATTGTTTC
TTTTAGTGACGGGAATTGTT -> TTTAGTGACGGGAATTGTTT
TGCCGATGCAGAATTTCGCT -> GCCGATGCAGAATTTCGCTG
ATGCCGATGCAGAATTTCGC -> TGCCGATGCAGAATTTCGCT
GCTTACAAACCAAGTGTACG -> CTTACAAACCAAGTGTACGT
AGCTTACAAACCAAGTGTAC -> GCTTACAAACCAAGTGTACG
GGCCAGGCGCATCAGTTTCA -> GCCAGGCGCATCAGTTTCAT
CGTGGTTCTTGTAAAAGTAT -> GTGGTTCTTGTAAAAGTATT
TCGCTGTCTGGAAGCGTAAA -> CGCTGTCTGGAAGCGTAAAC
ATCGGGCGTAAGAATAAGTC -> TCGGGCGTAAGAATAAGTCT
CAGTTTCATGTCGTTGGACA -> AGTTTCATGTCGTTGGACAT
TATGGCTATCTTTTACTTGC -> ATGGCTATCTTTTACTTGCG
AAGCTTAGCTCGCTGACCCC -> AGCTTAGCTCGCTGACCCCA
ACCCCATTGCTACACCTGTG -> CCCCATTGCTACACCTGTGG
GCCGGGTTTTTGGACGCGCC -> CCGGGTTTTTGGACGCGCCA
AGCCGGGTTTTTGGACGCGC -> GCCGGGTTTTTGGACGCGCC
TTTAAGTGGAGTTATAGAGG -> TTAAGTGGAGTTATAGAGGG
AGGCCGCGCGTAAGCCAGTG -> GGCCGCGCGTAAGCCAGTGC
GGCCGCGCGTAAGCCAGTGC -> GCCGCGCGTAAGCCAGTGCA
TAGACTCTAAGCTTAGCTCG -> AGACTCTAAGCTTAGCTCGC
AGACTCTAAGCTTAGCTCGC -> GACTCTAAGCTTAGCTCGCT
GCCACTCTATGGCTATCTTT -> CCACTCTATGGCTATCTTTT
GACTCAACACTAACAGTTTA -> ACTCAACACTAACAGTTTAA
TACCGGGCAACTGTTGGCTC -> ACCGGGCAACTGTTGGCTCT
GCCGTCAAGATTCCCGTCTA -> CCGTCAAGATTCCCGTCTAG
CGCCGTCAAGATTCCCGTCT -> GCCGTCAAGATTCCCGTCTA
AAGTCAGTCGCACATACAGG -> AGTCAGTCGCACATACAGGA
AAAGTCAGTCGCACATACAG -> AAGTCAGTCGCACATACAGG
AGTGGGAATCCAGCGACTAT -> GTGGGAATCCAGCGACTATC
TAGTGGGAATCCAGCGACTA -> AGTGGGAATCCAGCGACTAT
ACCGTCTAGCTGCGATCTCT -> CCGTCTAGCTGCGATCTCTG
GTCTACCGGGCAACTGTTGG -> TCTACCGGGCAACTGTTGGC
GTGCACCATACAATACTCCA -> TGCACCATACAATACTCCAT
AGTGCACCATACAATACTCC -> GTGCACCATACAATACTCCA
ATGTCGTTGGACATCAATAT -> TGTCGTTGGACATCAATATT
CATGTCGTTGGACATCAATA -> ATGTCGTTGGACATCAATAT
ATGGCTATCTTTTACTTGCG -> TGGCTATCTTTTACTTGCGA
AAACGTACAAAGTCAGTCGC -> AACGTACAAAGTCAGTCGCA
CAAACGTACAAAGTCAGTCG -> AAACGTACAAAGTCAGTCGC
TTATAGCTTACAAACCAAGT -> TATAGCTTACAAACCAAGTG
TCTAGACCTTTTTTTACCCT -> CTAGACCTTTTTTTACCCTC
GTGGCCGCATGGGCCAAAGT -> TGGCCGCATGGGCCAAAGTT
CAGGCGCATCAGTTTCATGT -> AGGCGCATCAGTTTCATGTC
CCAGGCGCATCAGTTTCATG -> CAGGCGCATCAGTTTCATGT
CTTTAAGCGAAAACGACCCA -> TTTAAGCGAAAACGACCCAC
GAATAAGTCTACGTGTAGGA -> AATAAGTCTACGTGTAGGAC
GGGAAGTATTCCTTTCGATA -> GGAAGTATTCCTTTCGATAG
AGCGTGGCCGCATGGGCCAA -> GCGTGGCCGCATGGGCCAAA
ACAGTTTAACGTCTCTTGAG -> CAGTTTAACGTCTCTTGAGA
GTACAAAGTCAGTCGCACAT -> TACAAAGTCAGTCGCACATA
CGTACAAAGTCAGTCGCACA -> GTACAAAGTCAGTCGCACAT
CAAAGTTAGCGAGGGCATTA -> AAAGTTAGCGAGGGCATTAC
GATATCAAGACTCAACACTA -> ATATCAAGACTCAACACTAA
GACCTTATAGCTTACAAACC -> ACCTTATAGCTTACAAACCA
ACCTTATAGCTTACAAACCA -> CCTTATAGCTTACAAACCAA
TCACCGCCACGCATGCGCAG -> CACCGCCACGCATGCGCAGC
GTCACCGCCACGCATGCGCA -> TCACCGCCACGCATGCGCAG
GCATCAGTTTCATGTCGTTG -> CATCAGTTTCATGTCGTTGG
AACCGGGCGTCTTCGTTCAT -> ACCGGGCGTCTTCGTTCATT
ACCAAGAAAAACCGGGCGTC -> CCAAGAAAAACCGGGCGTCT
AAACCGGGCGTCTTCGTTCA -> AACCGGGCGTCTTCGTTCAT
GTGTAGGACTCGCTGTAATT -> TGTAGGACTCGCTGTAATTT
GTGGTAGCATAGATGGGTCC -> TGGTAGCATAGATGGGTCCG
TGGTAGCATAGATGGGTCCG -> GGTAGCATAGATGGGTCCGC
AGGCGCATCAGTTTCATGTC -> GGCGCATCAGTTTCATGTCG
TTTTTTTACCCTCCGAGATA -> TTTTTTACCCTCCGAGATAT
TTTTTTACCCTCCGAGATAT -> TTTTTACCCTCCGAGATATC
TTCGACGCGTCTACCGGGCA -> TCGACGCGTCTACCGGGCAA
GTTCGACGCGTCTACCGGGC -> TTCGACGCGTCTACCGGGCA
AACCGGGTTTGATGTCTTGT -> ACCGGGTTTGATGTCTTGTA
TTGTTTCGACCTTATAGCTT -> TGTTTCGACCTTATAGCTTA
ATTTACAGTCCGTGGTTCTT -> TTTACAGTCCGTGGTTCTTG
TGTCAAAGATATATAGACTC -> GTCAAAGATATATAGACTCT
GCACATACAGGACCATCGGG -> CACATACAGGACCATCGGGC
GTCCGTGGTTCTTGTAAAAG -> TCCGTGGTTCTTGTAAAAGT
CGCAGCGTGGCCGCATGGGC -> GCAGCGTGGCCGCATGGGCC
GCAGCGTGGCCGCATGGGCC -> CAGCGTGGCCGCATGGGCCA
CCGAGATATCAAGACTCAAC -> CGAGATATCAAGACTCAACA
AGATTCCCGTCTAGTGGTAG -> GATTCCCGTCTAGTGGTAGC
AAGATTCCCGTCTAGTGGTA -> AGATTCCCGTCTAGTGGTAG
CTATACCGTACGCCACTCTA -> TATACCGTACGCCACTCTAT
TAAGAATAAGTCTACGTGTA -> AAGAATAAGTCTACGTGTAG
GGAATCCAGCGACTATCACG -> GAATCCAGCGACTATCACGG
GAATCCAGCGACTATCACGG -> AATCCAGCGACTATCACGGA
CTAACAGTTTAACGTCTCTT -> TAACAGTTTAACGTCTCTTG
TAGATATACGTCACCGCCAC -> AGATATACGTCACCGCCACG
GCCAGTGCACCATACAATAC -> CCAGTGCACCATACAATACT
CCAGTGCACCATACAATACT -> CAGTGCACCATACAATACTC
CTACATAGCAGAGCCGGGTT -> TACATAGCAGAGCCGGGTTT
AGTCCGTGGTTCTTGTAAAA -> GTCCGTGGTTCTTGTAAAAG
AGTGGTAGCATAGATGGGTC -> GTGGTAGCATAGATGGGTCC
GCCAGGCGCATCAGTTTCAT -> CCAGGCGCATCAGTTTCATG
GACACCACCCGTTTTGGACC -> ACACCACCCGTTTTGGACCG
GGACACCACCCGTTTTGGAC -> GACACCACCCGTTTTGGACC
TCTTGTAAAAGTATTCTCAG -> CTTGTAAAAGTATTCTCAGA
ATAGCGCAGCAAACTGCTAC -> TAGCGCAGCAAACTGCTACA
CTTCGTTCATTTTAGTGACG -> TTCGTTCATTTTAGTGACGG
TTTAACGTCTCTTGAGATAG -> TTAACGTCTCTTGAGATAGA
AGTTCTTCACGTCGCACTGT -> GTTCTTCACGTCGCACTGTC
CTGTGGGCGCATCTCGACAA -> TGTGGGCGCATCTCGACAAT
ATACGTCACCGCCACGCATG -> TACGTCACCGCCACGCATGC
AGACCTTTTTTTACCCTCCG -> GACCTTTTTTTACCCTCCGA
TGGGGACACCACCCGTTTTG -> GGGGACACCACCCGTTTTGG
TTACTTGCGAAGCTAACCGG -> TACTTGCGAAGCTAACCGGG
TCAAGATTCCCGTCTAGTGG -> CAAGATTCCCGTCTAGTGGT
CAAGATTCCCGTCTAGTGGT -> AAGATTCCCGTCTAGTGGTA
TTTACAGTCCGTGGTTCTTG -> TTACAGTCCGTGGTTCTTGT
GTTCATTTTAGTGACGGGAA -> TTCATTTTAGTGACGGGAAT
CGTTCATTTTAGTGACGGGA -> GTTCATTTTAGTGACGGGAA
GAGCCGGGTTTTTGGACGCG -> AGCCGGGTTTTTGGACGCGC
GCCGATGCAGAATTTCGCTG -> CCGATGCAGAATTTCGCTGT
CTTGCGAAGCTAACCGGGTT -> TTGCGAAGCTAACCGGGTTT
TTGCGAAGCTAACCGGGTTT -> TGCGAAGCTAACCGGGTTTG
GTGTCAAAGATATATAGACT -> TGTCAAAGATATATAGACTC
GTATTCCTTTCGATAGGTGA -> TATTCCTTTCGATAGGTGAG
TTTTACCCTCCGAGATATCA -> TTTACCCTCCGAGATATCAA
TTTACCCTCCGAGATATCAA -> TTACCCTCCGAGATATCAAG
CTAGCTGCGATCTCTGTGAT -> TAGCTGCGATCTCTGTGATT
TCTAGCTGCGATCTCTGTGA -> CTAGCTGCGATCTCTGTGAT
GCACTGTCTCATCATCACAG -> CACTGTCTCATCATCACAGG
CTGTCTCATCATCACAGGCT -> TGTCTCATCATCACAGGCTG
ACCACCCGTTTTGGACCGTC -> CCACCCGTTTTGGACCGTCT
TCTTTCTAGACCTTTTTTTA -> CTTTCTAGACCTTTTTTTAC
GTCTTTCTAGACCTTTTTTT -> TCTTTCTAGACCTTTTTTTA
TTACAAACGTACAAAGTCAG -> TACAAACGTACAAAGTCAGT
AAGTTAGCGAGGGCATTACA -> AGTTAGCGAGGGCATTACAA
CATACAATACTCCATGCCGA -> ATACAATACTCCATGCCGAT
GAAGTAGTAGATTCTCTAGA -> AAGTAGTAGATTCTCTAGAT
GCTCTGCGATCTGTGGGGAC -> CTCTGCGATCTGTGGGGACA
ATATAGACTCTAAGCTTAGC -> TATAGACTCTAAGCTTAGCT
TATATAGACTCTAAGCTTAG -> ATATAGACTCTAAGCTTAGC
GGGCGTAAGAATAAGTCTAC -> GGCGTAAGAATAAGTCTACG
GGAAGTATTCCTTTCGATAG -> GAAGTATTCCTTTCGATAGG
CCCACTGGTGCTTGTACTTG -> CCACTGGTGCTTGTACTTGG
GCGTAAGAATAAGTCTACGT -> CGTAAGAATAAGTCTACGTG
GGCGTAAGAATAAGTCTACG -> GCGTAAGAATAAGTCTACGT
TAAGTCTACGTGTAGGACTC -> AAGTCTACGTGTAGGACTCG
AAGTCTACGTGTAGGACTCG -> AGTCTACGTGTAGGACTCGC
TATAGCGCAGCAAACTGCTA -> ATAGCGCAGCAAACTGCTAC
TTAGAGTTCTTCACGTCGCA -> TAGAGTTCTTCACGTCGCAC
CTTAGAGTTCTTCACGTCGC -> TTAGAGTTCTTCACGTCGCA
TTGCTACACCTGTGGGCGCA -> TGCTACACCTGTGGGCGCAT
TCTGCGATCTGTGGGGACAC -> CTGCGATCTGTGGGGACACC
CTCTGCGATCTGTGGGGACA -> TCTGCGATCTGTGGGGACAC
GTTTAACGTCTCTTGAGATA -> TTTAACGTCTCTTGAGATAG
TGTACGTTCCTAGTGGGAAT -> GTACGTTCCTAGTGGGAATC
TTGTACGTTCCTAGTGGGAA -> TGTACGTTCCTAGTGGGAAT
ACTCTATGGCTATCTTTTAC -> CTCTATGGCTATCTTTTACT
AGTATTCCTTTCGATAGGTG -> GTATTCCTTTCGATAGGTGA
AAAAGTATTCTCAGACCGAG -> AAAGTATTCTCAGACCGAGC
AGTCAGTCGCACATACAGGA -> GTCAGTCGCACATACAGGAC
GTTTAAGTGGAGTTATAGAG -> TTTAAGTGGAGTTATAGAGG
GGGTTTTTGGACGCGCCATG -> GGTTTTTGGACGCGCCATGC
GCACCATACAATACTCCATG -> CACCATACAATACTCCATGC
TGCACCATACAATACTCCAT -> GCACCATACAATACTCCATG
CCTTTCGATAGGTGAGGCCG -> CTTTCGATAGGTGAGGCCGC
ACCAAGTGTACGTCTTTCTA -> CCAAGTGTACGTCTTTCTAG
CCAAGTGTACGTCTTTCTAG -> CAAGTGTACGTCTTTCTAGA
TCCTAGTGGGAATCCAGCGA -> CCTAGTGGGAATCCAGCGAC
AAAGTTAGCGAGGGCATTAC -> AAGTTAGCGAGGGCATTACA
GCATTACAAACGTACAAAGT -> CATTACAAACGTACAAAGTC
CATTTTAGTGACGGGAATTG -> ATTTTAGTGACGGGAATTGT
ATTTTAGTGACGGGAATTGT -> TTTTAGTGACGGGAATTGTT
TCCGCTTTAAGCGAAAACGA -> CCGCTTTAAGCGAAAACGAC
CTGTCATCCGTTCGACGCGT -> TGTCATCCGTTCGACGCGTC
CGATGCAGAATTTCGCTGTC -> GATGCAGAATTTCGCTGTCT
CACCATACAATACTCCATGC -> ACCATACAATACTCCATGCC
AAAACGACCCACTGGTGCTT -> AAACGACCCACTGGTGCTTG
CAGCGTGGCCGCATGGGCCA -> AGCGTGGCCGCATGGGCCAA
TCACGTCGCACTGTCTCATC -> CACGTCGCACTGTCTCATCA
GCGATCTCTGTGATTATAGC -> CGATCTCTGTGATTATAGCG
CAGACCGAGCTGGGGTTTAA -> AGACCGAGCTGGGGTTTAAG
GCTCGCTGACCCCATTGCTA -> CTCGCTGACCCCATTGCTAC
CGTCAAGATTCCCGTCTAGT -> GTCAAGATTCCCGTCTAGTG
GTCAAGATTCCCGTCTAGTG -> TCAAGATTCCCGTCTAGTGG
TTGGACCGTCTAGCTGCGAT -> TGGACCGTCTAGCTGCGATC
TTTGGACCGTCTAGCTGCGA -> TTGGACCGTCTAGCTGCGAT
GACCTTTTTTTACCCTCCGA -> ACCTTTTTTTACCCTCCGAG
ACGACCCACTGGTGCTTGTA -> CGACCCACTGGTGCTTGTAC
TTTGATGTCTTGTACGTTCC -> TTGATGTCTTGTACGTTCCT
GTCGCACATACAGGACCATC -> TCGCACATACAGGACCATCG
AGTCGCACATACAGGACCAT -> GTCGCACATACAGGACCATC
GGGAATCCAGCGACTATCAC -> GGAATCCAGCGACTATCACG
TGGGAATCCAGCGACTATCA -> GGGAATCCAGCGACTATCAC
TAAACCAAGAAAAACCGGGC -> AAACCAAGAAAAACCGGGCG
ACAAACGTACAAAGTCAGTC -> CAAACGTACAAAGTCAGTCG
TACAAACGTACAAAGTCAGT -> ACAAACGTACAAAGTCAGTC
CGAGATATCAAGACTCAACA -> GAGATATCAAGACTCAACAC
GAGATATCAAGACTCAACAC -> AGATATCAAGACTCAACACT
GGCGCATCAGTTTCATGTCG -> GCGCATCAGTTTCATGTCGT
CGGGCGTCTTCGTTCATTTT -> GGGCGTCTTCGTTCATTTTA
CCTTAGAGTTCTTCACGTCG -> CTTAGAGTTCTTCACGTCGC
CGTCTTTCTAGACCTTTTTT -> GTCTTTCTAGACCTTTTTTT
ACGTCTTTCTAGACCTTTTT -> CGTCTTTCTAGACCTTTTTT
GTACGTTCCTAGTGGGAATC -> TACGTTCCTAGTGGGAATCC
ATAGATGGGTCCGCTTTAAG -> TAGATGGGTCCGCTTTAAGC
CATAGATGGGTCCGCTTTAA -> ATAGATGGGTCCGCTTTAAG
ATTGTTTCGACCTTATAGCT -> TTGTTTCGACCTTATAGCTT
TTGGACATCAATATTACCCC -> TGGACATCAATATTACCCCT
TCCTTTCGATAGGTGAGGCC -> CCTTTCGATAGGTGAGGCCG
GGTTTTTGGACGCGCCATGC -> GTTTTTGGACGCGCCATGCA
GTGGGAATCCAGCGACTATC -> TGGGAATCCAGCGACTATCA
ACCCACTGGTGCTTGTACTT -> CCCACTGGTGCTTGTACTTG
CCGTCAAGATTCCCGTCTAG -> CGTCAAGATTCCCGTCTAGT
TTTTTACCCTCCGAGATATC -> TTTTACCCTCCGAGATATCA
CTGCTACATAGCAGAGCCGG -> TGCTACATAGCAGAGCCGGG
TACGCCACTCTATGGCTATC -> ACGCCACTCTATGGCTATCT
AACCAAGTGTACGTCTTTCT -> ACCAAGTGTACGTCTTTCTA
TAGAGTTCTTCACGTCGCAC -> AGAGTTCTTCACGTCGCACT
TCTTCGTTCATTTTAGTGAC -> CTTCGTTCATTTTAGTGACG
TCTAAGCTTAGCTCGCTGAC -> CTAAGCTTAGCTCGCTGACC
CCGATGCAGAATTTCGCTGT -> CGATGCAGAATTTCGCTGTC
CTCTAGATATACGTCACCGC -> TCTAGATATACGTCACCGCC
ACCCTCCGAGATATCAAGAC -> CCCTCCGAGATATCAAGACT
GCGATCTGTGGGGACACCAC -> CGATCTGTGGGGACACCACC
ACCGCCACGCATGCGCAGCG -> CCGCCACGCATGCGCAGCGT
CCGCCACGCATGCGCAGCGT -> CGCCACGCATGCGCAGCGTG
CATCCGTTCGACGCGTCTAC -> ATCCGTTCGACGCGTCTACC
TAGATTCTCTAGATATACGT -> AGATTCTCTAGATATACGTC
CACGTCGCACTGTCTCATCA -> ACGTCGCACTGTCTCATCAT
TCTCTAGATATACGTCACCG -> CTCTAGATATACGTCACCGC
TGTGGGCGCATCTCGACAAT -> GTGGGCGCATCTCGACAATA
CACCGCCACGCATGCGCAGC -> ACCGCCACGCATGCGCAGCG
GGGCATTACAAACGTACAAA -> GGCATTACAAACGTACAAAG
GGCATTACAAACGTACAAAG -> GCATTACAAACGTACAAAGT
TACGTGTAGGACTCGCTGTA -> ACGTGTAGGACTCGCTGTAA
CATCTCGACAATACATCACA -> ATCTCGACAATACATCACAC
AAACTGCTACATAGCAGAGC -> AACTGCTACATAGCAGAGCC
CAAACTGCTACATAGCAGAG -> AAACTGCTACATAGCAGAGC
TGGACGCGCCATGCAGCTAT -> GGACGCGCCATGCAGCTATA
GGACGCGCCATGCAGCTATA -> GACGCGCCATGCAGCTATAC
GCAGAGCCGGGTTTTTGGAC -> CAGAGCCGGGTTTTTGGACG
CAAGTGTACGTCTTTCTAGA -> AAGTGTACGTCTTTCTAGAC
GGTTTAAGTGGAGTTATAGA -> GTTTAAGTGGAGTTATAGAG
GGCTGCCACTGTCATCCGTT -> GCTGCCACTGTCATCCGTTC
AGATGGGTCCGCTTTAAGCG -> GATGGGTCCGCTTTAAGCGA
CGCCACGCATGCGCAGCGTG -> GCCACGCATGCGCAGCGTGG
AACTGCTACATAGCAGAGCC -> ACTGCTACATAGCAGAGCCG
GCCGCGCGTAAGCCAGTGCA -> CCGCGCGTAAGCCAGTGCAC
AATTTCGCTGTCTGGAAGCG -> ATTTCGCTGTCTGGAAGCGT
AGCCAGTGCACCATACAATA -> GCCAGTGCACCATACAATAC
GCGACTATCACGGATGTGTC -> CGACTATCACGGATGTGTCA
ACTGCTACATAGCAGAGCCG -> CTGCTACATAGCAGAGCCGG
GTCTAGTGGTAGCATAGATG -> TCTAGTGGTAGCATAGATGG
AGATATATAGACTCTAAGCT -> GATATATAGACTCTAAGCTT
GTTTTTGGACGCGCCATGCA -> TTTTTGGACGCGCCATGCAG
TTTCATGTCGTTGGACATCA -> TTCATGTCGTTGGACATCAA
AATCCAGCGACTATCACGGA -> ATCCAGCGACTATCACGGAT
GCGCATCTCGACAATACATC -> CGCATCTCGACAATACATCA
CGCATCTCGACAATACATCA -> GCATCTCGACAATACATCAC
TGTAGGACTCGCTGTAATTT -> GTAGGACTCGCTGTAATTTA
TAGATGGGTCCGCTTTAAGC -> AGATGGGTCCGCTTTAAGCG
GCATCTCGACAATACATCAC -> CATCTCGACAATACATCACA
CCCTCCGAGATATCAAGACT -> CCTCCGAGATATCAAGACTC
AGACCGAGCTGGGGTTTAAG -> GACCGAGCTGGGGTTTAAGT
TCATCATCACAGGCTGCCAC -> CATCATCACAGGCTGCCACT
TCACGGATGTGTCAAAGATA -> CACGGATGTGTCAAAGATAT
GCAAACTGCTACATAGCAGA -> CAAACTGCTACATAGCAGAG
CGTCACCGCCACGCATGCGC -> GTCACCGCCACGCATGCGCA
AGCTCGCTGACCCCATTGCT -> GCTCGCTGACCCCATTGCTA
GGAGAACTGAACGATCGCAT -> GAGAACTGAACGATCGCATA
AGATATCAAGACTCAACACT -> GATATCAAGACTCAACACTA
TTCTCTAGATATACGTCACC -> TCTCTAGATATACGTCACCG
GTTGGACATCAATATTACCC -> TTGGACATCAATATTACCCC
CGTCTAGTGGTAGCATAGAT -> GTCTAGTGGTAGCATAGATG
AAGCCAGTGCACCATACAAT -> AGCCAGTGCACCATACAATA
TTGGACGCGCCATGCAGCTA -> TGGACGCGCCATGCAGCTAT
CACGGATGTGTCAAAGATAT -> ACGGATGTGTCAAAGATATA
GGGTCCGCTTTAAGCGAAAA -> GGTCCGCTTTAAGCGAAAAC
TAGTGGTAGCATAGATGGGT -> AGTGGTAGCATAGATGGGTC
CATCATCACAGGCTGCCACT -> ATCATCACAGGCTGCCACTG
AAACCAAGTGTACGTCTTTC -> AACCAAGTGTACGTCTTTCT
CATGCGCAGCGTGGCCGCAT -> ATGCGCAGCGTGGCCGCATG
AGCAGAGCCGGGTTTTTGGA -> GCAGAGCCGGGTTTTTGGAC
AGCAAACTGCTACATAGCAG -> GCAAACTGCTACATAGCAGA
CAGTGCACCATACAATACTC -> AGTGCACCATACAATACTCC
TTCCTAGTGGGAATCCAGCG -> TCCTAGTGGGAATCCAGCGA
CCACCCGTTTTGGACCGTCT -> CACCCGTTTTGGACCGTCTA
CTGTAATTTACAGTCCGTGG -> TGTAATTTACAGTCCGTGGT
CTTGTACGTTCCTAGTGGGA -> TTGTACGTTCCTAGTGGGAA
AGCGAGGGCATTACAAACGT -> GCGAGGGCATTACAAACGTA
CATCGGGCGTAAGAATAAGT -> ATCGGGCGTAAGAATAAGTC
GGAGTTATAGAGGGAGAACT -> GAGTTATAGAGGGAGAACTG
CTGCGATCTGTGGGGACACC -> TGCGATCTGTGGGGACACCA
TGCGATCTGTGGGGACACCA -> GCGATCTGTGGGGACACCAC
CGCTGTAATTTACAGTCCGT -> GCTGTAATTTACAGTCCGTG
GCTGTAATTTACAGTCCGTG -> CTGTAATTTACAGTCCGTGG
GTAAACCAAGAAAAACCGGG -> TAAACCAAGAAAAACCGGGC
CGCATCAGTTTCATGTCGTT -> GCATCAGTTTCATGTCGTTG
GCGCATCAGTTTCATGTCGT -> CGCATCAGTTTCATGTCGTT
CACCCGTTTTGGACCGTCTA -> ACCCGTTTTGGACCGTCTAG
